OTS	OTQ
"-pasadores: ""ya nts'äza xi mra nts'u̱t'i mi t'e̱ni ko n'a ra t'e̱nga ts'u̱t'a bo̱kja mi tjutuabi ra ballesta""."	"-pasadores: ""ya nts'äza xi mra nts'u̱t'i mi t'eni ko n'a ra t'enga ts'u̱t'a bo̱kja mi tjutuabi ra ballesta""."
"cantares mexicanos, biblioteca nacional de méxico, ya nt'ofo 1628 bis, folio 16 v."	"cantares mexicanos, biblioteca nacional de méxico, ya nt’otho 1628 bis, folio 16 v."
"ebu̱ bi bo̱ni, bi meui nuni nonohualco, ja ra ngu ra b'ongui jabu̱ ra gabida ne ra malintzin ne ""ra jyadi"" (alvarado) ne ra sandoval."	"ebu̱ bi bo̱ni, bi meui nuni nonohualco, ja ra ngu ra b'ongui jabu̱ ra gabida ne ra malintzin ne ""ra yadi"" (alvarado) ne ra sandoval."
gi jandi ra nt'ofo ra tjuju ra crónicas de la conquista	gi xandi ra nt’otho ra jiju ra crónicas de la conquista
"guzmán. ja ya je̱m'i b'e̱tsa kje̱ya manteb'u̱ di ge nuua m'onda ne ya jyo, nu'a ra jmä ra 12-conejo (1530) ge xa jmä ge xibú bi yut'i ja ra culhuacan ya ndeznä, nda pablo xochiquetzin, motelchiuhtzin ne ra guzman."	"Guzmán. Ja ya hëmi bët'a këyä manthe'bu di ge nuwa monda ne ya jyo, nu'a ra jmä ra 12-conejo (1530) ge xa jmä ge xibö bi yot'i ja ra Culhuacan ya ndetsnä, nda Pablo Xochiquetzin, Motelchiuhtzin ne ra Guzmán."
"ja ga ñ'udiju̱ ra nt'ofo ya ñämfo̱ po ra ntjuts'i ra doctor garibay,"	"xa ga ñ'udižu̱ ra nt'otho ya ñätho̱ po ra nt'uts'i ra doctor garibay,"
ja nu'a jyodi nubia tjutuabi ra san martin.	xa nu'ä yodi nubia chuchuabi ra San Martín.
"je̱mi unga mfädi ja ra t'u̱ka jnini jabu̱ b'u̱i ya kjä'i teni ra división ra arenas, 27 ra abril ra kje̱ya 1918, ra m'ets'a je̱m'i ra zapata, b'e̱tsi ja ra universidad nacional autónoma de méxico, expediente 29."	"Jämi hingi mfädi ha ra t'uka nxüni hñäbu b'ui ya kä'i teni ra división ra arenas, 27 ra abril ra käya 1918, ra m'ets'a jämi ra zapata, b'ëtsi ha ra universidad nacional autónoma de méxico, expediente 29."
"m'e̱fa ja ra jñuti bri tjätuabi na ra jñe xki tagiri mo̱te, neje bri kjom'a ra xu̱tja ko n'a ra t'axa dutu mra tjujuu ra ""campanillante""."	"m'efa ja ra ñuti bri tyätuabi na ra ñä xki tagiri möthe, neje bri kyoma ra hütxa ko n'a ra t'axa duthu mra tjuju ra ""campanillante""."
"ma dada'ije gra ts'u̱tui, di ne gi pädi ge ma me̱t'o instä tjogije nuna tjogi gatjo ya mapa xki r'ani, bi kjuat'i ko ngeke nu̱'u ri b'e̱go, ri me̱fi ya ñämfo̱, ra nge'a makjuäni ra hernando cortés ra ndä gabida,"	"ma tada'ije gra ts'ütui, di ne gi pädi ge ma mätho instä tjogije nuna tjogi gatjo ya mapa xki rani, bi kjuathi ko ngeke ñu'u ri bëgo, ri mäfi ya ñämfo, ra nge'a makjuäni ra hernando cortés ra ndä gabida,"
mi b'u̱i ya mu̱dimejai mi ñä ra ndeznä ne jabu̱ ra jnini dige'a gatjo ra nxiki m'onda ngu r'a ya yaqui b'u̱i nuni sonora ne ya maya ri ñ'eje nuni yucatán ra nge bi guat'i ja ra tujni bi nkja nuua m'onda fädi ko ra tjuju ra revolución mexicana ya kje̱ya 1910-1919.	mi b'ui ya mu̱dimehai mi ñä ra ndezna ne xabu̱ ra jnini dige'a gatjo ra nxiki m'onda ngu r'a ya yaqui b'ui nuni sonora ne ya maya ri ñ'eje nuni yucatán ra nge bi guat'i ja ra tujni bi nkja nuua m'onda fädi ko ra tjuju ra revolución mexicana ya kje̱ya 1910-1919.
mi fo̱tuabi ya ts'u̱tnibo̱kja mi tjutuabi ya jñämfo̱ ra pasadores neje ya bo̱zna ko ya nzafi.	mi fotuabi ya ts'utnibo̱kja mi txutuabi ya ñämfo̱ ra pasadores neje ya bozna ko ya nzafi.
"n'a nt'udi di ge'a nuya ntjoki bri t'o̱t'e ja ya jñä ya ndeznä ra ngätsi ra ntjebe nkje̱ya ra r'e̱t'a ma gu̱to (s. xix), r'a ya jnini ngu ra xicontepec (villa juárez) nuna jyodi koji nuni puebla."	"n'a nt'udi di ge'a nuya nt'oki bri t'ot'e ja ya ñä ya ndezna ra ngätsi ra nt'ebe nk'eya ra r'et'a ma guto (s. xix), r'a ya ñ'eni ngu ra xicontepec (villa juárez) nuna yodi koji nuni puebla."
"n'a ra t'axa dutu mi pe̱tsi ya k'oi ra ixki, nuna mra tjuju jñämfo̱ ""campaneante resonador""."	"n'a ra t'axa dutu mi pe̱tsi ya k'oi ra ixki, nuna mra tjuju ñämfo̱ ""campaneante resonador""."
"ne ri mpe̱fi ja ra dängan gu nt'udi ra tjuju ra facultad de estudios superiores, acatlán, unam,"	"ne r'i mpefi ha ra dänga go nt'udi ra t'ut'u ra facultad de estudios superiores, acatlán, unam,"
"ntjandi gatjo nu'a ra munts'i ra tjuju jñämfo̱ ra globalización ge 'a po̱ts'e dega nest'iji, nuna y'o̱te to̱m'i da nkja ra ntjo̱mäte."	"nt'andi gato nu'a ra mints'i ra t'ut'u ñämfo ra globalización ge 'a po̱ts'e dega nest'iji, nuna y'o̱te to̱mi da nkja ra nt'ot'äti."
"nu'a ma r'a ya kjä'i mi pädi nuña b'e̱fi bri b'e̱pabi xa jyoki yojo ya mpe̱fi mi fädi ko ra tjuju ra amosqueador ko ya xi ya ts'ints'u̱ xi sta jotjo, gi jutsuabi made dige'a n'a ra zänä dega k'astabokja"	"nu'a ma r'a ya kä'i mi pädi nuña b'efi bri b'epabi xa yoki yoho ya mpefi mi fädi ko ra tjuju ra amosqueador ko ya xi ya ts'ints'u xi sta jotjo, gi jutsuabi made dige'a n'a ra zänä dega k'astabokja"
"nu'a ra munts'a kjä'i bi te̱ni bi zipabi man'a ya b'ede, mi t'ena ge ya kjä'i xki b'u̱i nubu̱ inbi pe̱tsi ra ts'e̱di nu'a mi mä pe m'e̱fa bi kjapi bi nxaxni ya tsu̱tui ne n'a ra diputado mi pe̱tsi ra mfeni xki kot'i mra tjuju ra josé maría lozano, bi y'onga ra jmä pa mar'a ya ñ'oui bi nxanxi: ""ri mo̱te ra tjits'i mi udi ra emiliano zapata, neje bri fädi ngu ra atila nuna bri nkju̱tsi [...] nu'a bi fädi ngu mi je̱gi ya b'e̱go ne'a bi mä da uni da nkja pa gatjo, ingi kjot'i [...]"	"nu'a ra mints'a kä'i bi te̱ni bi zipabi man'a ya b'ede, mi t'ena ge ya kä'i xki b'u̱i nubu̱ inbi pe̱tsi ra ts'e̱di nu'a mi mä pe m'e̱fa bi käpi bi nxaxni ya tsu̱tui ne n'a ra diputado mi pe̱tsi ra mfeni xki kot'i mra tjuju ra josé maría lozano, bi y'onga ra jmä pa mar'a ya ñ'oui bi nxanxi: ""ri mo̱te ra jits'i mi udi ra emiliano zapata, neje bri fädi ngu ra atila nuna bri nkju̱tsi [...] nu'a bi fädi ngu mi je̱gi ya b'e̱go ne'a bi mä da uni da nkja pa gatjo, ingi kot'i [...]"
nu'u̱ to'o ñä ra ndenzä ja r'e̱t'a ma r'at'o ya estados.	ñuhu tho ñä ra ntheza ja r'et'a ma r'at'o ya estados.
"nub'u̱ ri m'e̱jni ne ri b'e̱go ya ñämfo̱ bi kjuat'i ko ngekagije ne bi tso̱jo̱ ra gabida ra tjuju ra hernán cortés, maske indi pädije ge gatjo da za da o̱t'e ne xi ra nzunda maría trinidad,"	"nub'ú ri m'äñeni ne ri b'ëgo ya ñä'ä mfö bi kjuat'i ko ngekagixe ne bi tso̱ho̱ ra gabida ra t'üt'u ra hernán cortés, maske indi pädihe ge gatjo da za da o̱t'e ne xi ra nzonda maría trinidad,"
"nubia, unga mfädi ja ra ñäjñu kjamädi ra universidad autónoma del estado de hidalgo."	"Nubya, 'na mfädi ya ra ñäñu xkamädi ya Universidad Autónoma del Estado de Hidalgo."
"nugi, ra miguel hernández ge di pe̱tsi ma ngu nuni chiyauhtzinco, ko ra t'ek'ei di udi ko nge'i, nuna m'e̱jnant'ofo di joki go tso̱n'i ko nge'i, ma t'ek'ei bo̱najmu'i nda doctor alonso ruiz, ra nk'ojnate ge gi b'ui nuua ja ra jnini ra quamochtitla."	"nugi, ra miguel hernández ge di pe̱tsi ma ngu nuni chiyauhtzinco, ko ra t'ek'ei di udi ko nge'i, nuna m'e̱jnant'ofo di joki go tso̱n'i ko nge'i, ma t'ek'ei bo̱najmu'i nda doctor alonso ruiz, ra nk'ojnate ge gi b'ui nuua ja ra jnini ra quamochtitla."
"nuna je̱m'i bri t'unga mfädi ko ra t'u̱ka ntjint'ant'ofo po ra marcelo díaz salas ne ra luis reyes garcía ja: tialtocan, revista de fuentes para el conocimiento de las culturas indígenas de méxico, vol. vi, 1970, b'ede ra 3, pp. 193-212."	"nuna hingi b'ri t'unga mfädi ko ra t'oka nt'ot'anfotho po ra marcelo díaz salas ne ra luis reyes garcía ja: tialtocan, revista de fuentes para el conocimiento de las culturas indígenas de méxico, vol. vi, 1970, b'ede ra 3, pp. 193-212."
"nuna jñäpi juts'i ja n'a ra je̱m'i fädi ra derecho canonigo ko ra tjuju jñämfo̱ ngu ra ""solicitación al administrar el sacramento de la confesión""."	"nuna ñäpi hutsi ha n'a ra hëmi fädi ra derecho canonigo ko ra t'ut'u ñämfo̱ ngu ra ""solicitación al administrar el sacramento de la confesión""."
"nuna m'e̱jna nt'ofo b'e̱tsi ja ra archivo histórico nacional, madrid, documento 165. bi unga mfädi ja ra nt'ofo ya zubi po ra y'ofo ra tjuju ra arthur j. o. anderson et al.: byond the codices: the nahua view of colonial mexico, berkeley, university of california press, 1976, pp. 181-187."	"nuna m'ejna nt'ofo b'ëtsi ha ra archivo histórico nacional, madrid, documento 165. bi unga mfädi ha ra nt'ofo ya zubi po ra y'ofo ra tjuju ra arthur j. o. anderson et al.: byond the codices: the nahua view of colonial mexico, berkeley, university of california press, 1976, pp. 181-187."
"nuna nt'ofo b'e̱tsi ja ra archivo general de indias, sevilla, audiencia de méxico 168, bi unga dra fädi po ra miguel león-portilla ja cultura en peligro, méxico, alianza editorial mexicana, 1976, pp. 102-103."	"nuna nt’otho b’ëtsi ha ra archivo general de indias, sevilla, audiencia de méxico 168, bi hingi ra fädi po ra miguel león-portilla ha cultura en peligro, méxico, alianza editorial mexicana, 1976, pp. 102-103."
"nuna pika je̱m'i kja te mä b'e̱tsi ja ra archivo general de la nación, nuua m'onda ne kja ja ra nduntji ya jnini, njabu̱ ngu ya nzaya nuni manjyati ne mar'a ya jnini, o̱t'e gi o̱de ra jñä ra mu̱dimejai."	"nuna pica häm'i kja te mä b'ëtsi ja ra archivo general de la nación, nuwa m'onda ne kja ja ra nt'unt'i ya hñeni, ñabu̱ ngu ya nzaya nuni manthi ne mar'a ya hñeni, o̱t'e gi o̱de ra ñä ra mu̱dimehai."
"nuua t'unga yojo ya jmä, kuän'ajmä ya ndeznä ne tjuts'i ja n'a ra k'oi mä mäkjuäni ri ntje̱ui n'a ya dänga ra tju̱ajmä manteb'u̱, nuua pede nu'a gatjo ya ts'otjogi bi y'o̱t'a dega fete ra alvarado."	"nuä t'unga yoho ya jmä, kuän'ajmä ya ndeznä ne tjuts'i ja n'a ra k'oi mä mäkjuäni ri ntjehui n'a ya dänga ra tjuajmä manteb'u, nuä pede nu'a gatjo ya ts'otjogi bi y'ot'a dega fete ra alvarado."
"nuua ya mu̱di noya ra motolinia, ja ra mu̱di nkoji bi t'o̱t'e ko ra tjuju ra tratado tercero ra dänga b´ede ya mu̱dimejai nuua r´ayo manjyati:"	"nu'u ya mudi nuya ra motolinia, ha ra mudi nkohi bi t'ot'e ko ra txutxu ra tratado tercero ra dänga b'ede ya mudimehai nu'u rayo manthiati:"
"pa da t'unga mfädi gatjo nu'u̱ bi nkja, n'a di ge'u̱ ko ngu fe̱ti nu'a makjuäni mi joki mi tjutsuabi ya jnei ne ya b'ida. b'u̱i man'a ra mfädi da t'o̱t'a ra nt'udi, nu'a ra tjuju ""fe̱ta nu'a makjuäni bi nja nub'u̱ ra tsokat'o̱tamfeni (teatro de la conquista)""."	"pa da t'unga mfädi gatjo nu'u̱ bi nkya, n'a di ge'u̱ ko ngu fethi nu'a makjuäni mi hoki mi tsutsuabi ya hnei ne ya b'ida. b'u̱i man'a ra mfädi da t'o̱t'a ra nt'udi, nu'a ra tjuju ""fetha nu'a makjuäni bi nja nub'u̱ ra tsokat'o̱tamfeni (teatro de la conquista)""."
"ra europa -mra nxika jai manteb'u̱, mi pe̱tsa n'a ra nxika b'ede-"	"ra europa -mra nxkiha hingi manthe̱b'u̱, mi pe̱tsa n'a ra nxkiha b'ede-"
"ra fernando ramírez mä ge nuna jyodi ri nge̱pu̱ jabu̱ kja n'a ra nikja ra san fernando ne ra ermita dige'a ya mártires dige'a san hipólito,"	"ra fernando ramírez mä ge nuna yodi ri nge̱pü̱ habu̱ kja n'a ra nikja ra san fernando ne ra ermita dige'a ya mártires dige'a san hipólito,"
"ra fernando de alva ixtlilxóchitl, fernando de, xiii relación: ""ra ñ'eje ya ñämfo̱ ne ra fu̱di ra nkanfri ra evangelio""."	"ra fernando de alva ixtlilxóchitl, fernando de, xiii relación: ""ra ñäjä ya ñämfo̱ ne ra hño ra nkäfri ra evangelio""."
"ra kuän'ajma ra n luz jiménez bi juts'i ra fernando horkasitas bi unga mfädi ne bi r'atsi nuña jmä), de porfirio díaz zapata, memoria nábuatl de milpa alta, méxico, unam,, instituto de investigaciones históricas, 1974, p. 105"	"ra kuän'ajma ra n luz jiménez bi juts'i ra fernando horkasitas bi unga mfädi ne bi r'atsi nuña jmä), de porfirio díaz zapata, memoria náhuatl de milpa alta, méxico, unam, instituto de investigaciones históricas, 1974, p. 105"
"ra raymundo isidro alavez, bi b'u̱i'i nuni ra boxtha chico, san salvador, estado de hidalgo"	"ra raymundo isidro alavez, bi b'ui'i nuni ra boktha chico, san salvador, estado de hidalgo"
"ra jmä ra fundación de santo tomás ajusco, archivo general de la nación, méxico, ramo de tierras vol. 2676, expediente. 4, archivo histórico de la biblioteca nacional de antropología, colección antigua, vol. 254, fojas 259 r.- 260 v."	"ra jmä ra fundación de santo tomás ajusco, archivo general de la nación, méxico, ramo de tierras vol. 2676, expediente. 4, archivo histórico de la biblioteca nacional de antropología, colección antigua, vol. 254, fojas 259 r.- 260 v."
"ra makja mra tjuju ra toribio benavente, motolinia,"	"ra makxa mra thotho ra toribio benavente, motolinia,"
"tlauhquechol: ra ts'ints'u̱ xa ntjeni pode ge'a ra flamenco o ra guacamaya, pode ge gatjo ra tje̱nga ts'ints'u̱ ne dänga."	"Tlajkwechol: ra ts'ints'u̱ ja ntheni pode ge'a ra flamenco o ra guakamaya, pode ge gatjo ra tje̱nga ts'ints'u̱ ne dänga."
"xkri tso̱ngä ngostji, kja jejni ya 'ñu; nä'ä rí ma nxamädo, ja nä'ä rí ma mäbo̱za. antes de"	"xkri tso̱ngä ngosthi, kja hñeni ya ñu; nä'ä ri ma nxamädo, ja nä'ä ri ma mäbo̱za. antes de"
"ya b'e̱go ne ya b'e̱tri di ge'a nu'a ra dänga ndä ra ndada ra tjuju ra esteban de guzmán ra nzaya di gekua m'onda, ra ndada ra hernando pimentel, ra ndada ra antonio cortés, ra ndada xuua (juan) nuna ra mecoyoacan, ra ndada pedro motecuhzoma, me ma r'a ya kuänmi (firmas)."	"ya bꞌe̱go ne ya bꞌe̱tri di geꞌa nuꞌa ra dänga ndä ra ndada ra tjuju ra esteban de guzmán ra nzaya di gekua mꞌonda, ra ndada ra hernando pimentel, ra ndada ra antonio cortés, ra ndada xuꞌu (juan) nuna ra mecoyoacan, ra ndada pedro motecuhzoma, me ma rꞌa ya kuänmi (firmas)."
"ya kuän' ajmä xa tjogi manteb'u̱e ge xa tjäst'i nu'a gatjo ra ntjandi to'o bi b'e̱di ge xa pu̱ngajñä nuna jmä getbu̱ n'ate ya jñäki ge ñä ya nso̱jo̱ jñäki ne xa y'oni nuna nt'ofo neje ja ra jñäki yazi xada kjä'i , ge'a nuna jñäki fadi ja ra jñämfo ko ra tjuju ra sistema braile."	"ya kuänts'i hmä xa tjogi manthe'b'e ge xa tjäst'i nu'a gatjo ra nt'andi to'o bi b'e̱di ge xa phungajñä nuna hmä gethe n'ate ya jñäki ge ñä ya nzho̱ho̱ jñäki ne xa y'oni nuna nt'ofo neje ha ra jñäki yathi xatha kjä'i, ge'a nuna jñäki fathi ha ra jñämfo ko ra t'ut'u ra sistema braille."
"ya r'atsanoya ra sahagán, ndoxkjua k'oi florentino, lib. xii, caps. xxix-xli (versión de ángel ma. garibay k.)."	"ya r'atsanoya ra sahagán, ndoxkjuä k'oi florentino, lib. xii, caps. xxix-xli (versión de ángel ma. garibay k.)."
despwés ya desde k'a ra momento ya k'a ya jíngi bénya'wi já té bimáju̱ k'a ra charroya'wi	despöes ya desde ga ra momento ya ga ya hingi bänthiwi ja te bimáju̱ ga ra charroya'wi
despwés ya xo bimu̱fí pe xo diario diario bu̱ nchúi mitsu̱ k'a ra charro mi'óbí k'a ra mikwála	después ya xo bimuhpi pe xo diario diario bu̱ nt'ui mits'u k'a ra charru mi'obi k'a ra miquála
goparejájé primero 'á k'a ra parte ánk'ú dínant'í	goparexáxe primero 'na k'a ra parte 'ñɨk'ɨ dínandi
i asta fecha pues ignoro mucho pero másk'ŭ mäkjámá más ndímáignorajéwi	i hasta fecha pues ignoro mucho pero másk'ü mäkjámá más ndímáignorajéwi
indu̱odiagí bastante	ndu̱diagi bastahti
"inga se̱je̱ ra nntjandi ra manjyati ne ra portuguesa neje ra francesa, inglesa, alemana e italiana,"	"inga seje ra nthe̱thi ra ma̱nyäti ne ra portuguesa neje ra francesa, inglesa, alemana e italiana,"
k'a mädämé para ke mantenigíjé dígotjó mäbäjtsí pues ni modo dísufréjé	Gä mät’äm’ë para ke mantenhëjï di’goht’o mä bätsi pues ni modo di’sufrïhë.
kómá'u̱té ya fuente níjí	kómá'ute ya fuente ñäjï
"ne bi unbabi nduntji ya baba, bi enbabi ge mi ne da ñäui ra ndä (emperador) mi b'u̱i nuni manjyati, ne da jäni ra dänga ts'ofo ra evangelio,"	"ne bi unbabi ndunt'i ya bä, bi enbabi ge mi ne da ñäwi ra ndä (emperador) mi b'ui nuni manthi, ne da jäni ra dänga ts'ofo ra evangelio,"
normalmente gójo	Normalme̱nte hñoho
panteón ga dó	pantheon ge do
pero de sesenta pantsítjá pa gotjók'ŭ kompletamente xatjó ndímáfădijé	pero de sesenta pants'itʃa pa gotʃok'i kompletamente xatʃo ndima̱fadihe
pero eso sí binújgí mängŭjé kada ná	Pero eso sí bí núkí manguye cada nää.
"po nuya kja'i to'o mi pede ge fädi ko ra tjuju ya ""cronistas de las indias”"	"po nuya kja'i to'o mi peze ge fädi ko ra t'ut'u ya ""cronistas de las indias"""
pues este kábádá balewa este mínimo siento sinkwenta	pues hingi kábádá mbate hingi mínimo siento sinkwenta
pues nimodo bisufré k'a más ante mäabwelitajé komo mbu̱i enkajoso ra ntsoya	pues nimodo bisufri k'a más ante mä abwelitajä komongu̱i enkañoso ra nts'oya
"ra nku̱t'i ra juajni ne ya ñ'udi ntjutsi ra agustin yáñez 2da. edición. biblioteca del estudiante universitario, unam, 1950."	"ra nkuth'i ra huaxni ne ya ñudi nthutsi ra agustin yáñez 2da. edición. biblioteca del estudiante universitario, unam, 1950."
solamente ya riko alkansabi	Solamente ya riko alkansabi
xi ra tí na ta komedór 'á itsí na ta alimento k'a ra ndăni	Xi ra ti na tha komedor 'á its'i na tha alimento k'a ra ndäni.
xo mitajá ra ntsoya mitá sínko pesos ra béjña dos sinkwenta	xu mitha ra nts'oya mitha hñoho pesos ra bäxä dos sinkwenta
xo takja mä sesenta wik'a takja mä sesenta bitajkíjéya'wik'a	xo thakjä mä sesenta wihña thakjä mä sesenta b'itha hñäwihña
á panteón ga dó níjí	a pantheon ga do nixi
ñúdigejña dabadijíya' razo''ya' mientra más dandu̱jté	ñudiheñä dabadihi ya räzo ya mientra más dandu̱hte
"-nu'u̱ dige'u̱ b'u̱i nuni maxey (tolimán ne amealco), dige'u̱ temoaya nuni ra ra jyodi estado de méxico ne mar'a ya jyodi nuni puebla ne veracruz"	"-nthuhü dige'ü b'ui nuni maxei (tolimán ne amealco), dige'ü temoaya nuni ra ra jñudi estado de méxico ne mar'a ya jñudi nuni puebla ne veracruz"
"ne mätajekitjo di kja getbu̱, ra jñäpi ra joel martinez hernández ne ra jotjo tjuajmä ra natalio hernández xocoyotzin, nuya yojo ya xajnate ri ñ'eje ya y'u̱ dige'u̱ ya ndeznä."	"ne mätäkithi di kja get’bu, ra ñämpi ra joel martinez hernández ne ra hño t’ui ra natalio hernández xocoyotzin, nuya yoho ya xajnate ri ñä’e ya y’u̱ dige’u̱ ya ndezna."
"-n'ate pa n'a ra zänä de ra r'e̱t'a ma jñäto ""zänä"" mi zo̱ta ya munts'i ya n'ate ya pa ge mi joki ra xihuitl o ""ra m'ede ra kje̱ya"""	"-näte pa n'a ra zänä de ra r'et'a ma ñäto ""zänä"" mi zotha ya mints'i ya näte ya pa ge mi hoki ra xihuitl o ""ra mäde ra k'eiya"""
bi ma di gepu̱ jam''u̱ ra ngo pa da ts'itje ya it'adeje (Tlahuano) ba po̱ni nubu̱ tlapechhuan. mra ngo ra izcalli.	bi ma di hñepu̱ ham'u̱ ra ngo pa da ts'it'i ya it'atehe (Tlahuano) ba po̱ni nubu̱ tlapechhuan. mra ngo ra izcalli.
bi mu̱di da jyoka ya t'u̱kats'u̱fabo̱kja. ge'a ra ntujni bi nkja nuni Coyohuehuetzin ne ma gojo ba nkja.	bi mudi da yoka ya t'ukats'ufabokja. ge'a ra nt'uni bi nka nuni Coyohuehuetzin ne ma goho ba nka.
"bri tjo ra cuauhnochtli, ra gabida tlacatecco, ra cuapan, ra gabida huitznáhuac, ra makja Amantlan, ne ra makja tlacopan."	"bri t’o ra kwaxnoxt’i, ra habida t’lakateko, ra kwapan, ra habida witsnawa, ra makxa Amantlan, ne ra makxa t’lakopan."
bri ts'u̱tuabi ja ra y'u̱ga n'a ra nto̱de dega t'u̱ka joga do dega chalchihuite: made mi juts'i n'a ra tsant'i dega k'astabokja.	bri ts'utuabi ja ra y'uga n'a ra nt'ode dega t'uka joga do dega chalchihuite: made mi huts'i n'a ra tsant'i dega k'astabokja.
"Castañeda, ra t'u ra Aquiyahualcatecuhtli, m ra ndä nuni tlaxcala."	"Castañeda, ra tu ra Aküyahualkatekuhtli, m ra nda nuni tlaxkala."
Coaíhuitl mra gabida ndeznä nuya mapa digeá ra t'o̱t'ats' okamfeni.	Kuaíhuitl mra habida nthäzä nuya mapa digea ra t'ot'ats' okamfeni.
di gepu̱ ba koi pa nuni ra Xochimilco. nubu̱ ba tu ya kjä'i ya metlatelolco	di hñepu̱ ba ko'i pa nun'i ra Xochimilco. nu'bü ba tu ya kä'i ya Metlatilolco
"ebu̱ ba eje man'aki ba te̱nga ra t'o̱jo̱ ra tjuju ra Citlaltépec. Tlacopan, nubia ba o̱t'ra b'u̱i ja ra ndo̱m'ijmu."	"ebu̱ mba eje man'aki mba te̱nga ra t'o̱ho̱ ra tjuju ra Citlaltépec. Tlacopan, nubia mba o̱t'ra b'u̱i ja ra ndo̱m'ijmu."
ebu̱ bi dädi ra Cihuacóatl:	hñä ebi dädi ra Cihuacóatl:
ebu̱ bi ñä ra Cuauhtémoc bi xipabi ra Cihuacóatl:	'bu̱ bi ñä ra Cuauhtémoc bi xipabi ra Cihuacóatl.
"gojo n'ate ya pa ne ebu̱ bi yopa bo̱ni pa di mani ra Huaxtepec, ra Cuauhnahuac (Cuernavaca)."	"Goho n’ate ya pa ne ebu̱ bi yopa bo̱ni pa di mani ra Waxtepeki, ra Kuauhnawak (Cuernavaca)."
"gue dá nhuat'i mbo kja ra ximjai,"	"ge dá ñu'ati mbo ja ra ximhai,"
"i nte ra nge'a, ya jmä juts'i ja ra ndäxkjua k'oi ra códice ra ramírez uni nuna b'e̱de mä makjuäni ngu mä ra ntje̱ka b'ede ne ra ndädi nu'a ra nänä mra tjuju ra yacotzin, ra nänä ra ixtlilxóchitl,"	"i nthe ra nge'a, ya jäme hut'i ha ra ndäxkjua k'oi ra códice ra ramírez uni nuna b'e̱the mä makjuäni ngu mä ra nt'e̱ka b'ethe ne ra ndädi nu'a ra nänä mra tjuju ra yacotzin, ra nänä ra ixtlilxóchitl,"
"inda jyo ko ra ndäxjua ixtlilxóchtil, ra dada ra Nezahualcóyotl ni ko ra fernando de alva ixtlilxóchitl."	"inda yo go ra ndäxhua ixtlilxóchitl, ra tada ra Nezahualcóyotl ñä go ra Fernando de Alva Ixtlilxóchitl."
"k o ya bu̱' bai, ko ya makahuai,"	"Go ya bu̱’ mbai, ko ya makahuai,"
"mi fudi da t'axka ra xudi ba ts'i, bri tját'a ja n'a ra za mi b'ai ja ra ngu ra Ahuizotzin nuni ra Acatliyacapan."	"mi fudi da t'axka ra xudi ba ts'i, bri tját'a ja n'a ra za mi b'ai ja ra ñu ra Ahuizotzin nuni ra Acatliyacapan."
mi gu̱t'a ra ñ'u̱ n'a ra makja ge'a mra b'e̱fi mi zu nu'a ra mäka jai mra tjuju ra Yohualichan.	mi gut'a ra ñ'u n'a ra makxa ge'a mra b'efi mi zu nu'a ra mäka hai mra t'ut'u ra Yohualichan.
"mi y'o y'oua, mi tuts'i ya bu̱'bai dega za, ne r'a mi jä dega bo̱ja ne ya mahuai."	"mi y'o y'ua, mi t'uts'i ya bu'bai thega za, ne r'a mi jä thega boja ne ya mahuai."
mra ngu ra Aztautzin ge'a mi kja getbu̱ nuni ra Amáxac.	mra ngu ra Aztawts'i ge'a mi kja get'bu̱ nuni ra Amáxa.
n'a ra jyo ne man'a bi xokuabi ra debi. ra Cuauhtemoctzin bri xokuabi ra debi ge'a se̱je̱.	n'a ra jyo ne man'a bi xkabi ra tebi. ra Cuauhtemoctzin bri xkabi ra tebi ge'a seje.
"ne m'e̱fa bi ma xki jäki ya je dega magabi, ñätsi bi ntsaya ra mahuai ne ra bu̱'bai, bri nkjonda ya bo̱najmu nuni Acachinanco."	"ne m’efa bi ma xki jäki ya hñe dega magabi, ñätsi bi ntsa ra mahuai ne ra bu'bai, bri nk’onda ya bo’nañu nuni Acachinanco."
"ne nkjabu̱ bri t'ot'e neje ko mar'a ya bo̱najmu mi pe̱tsi ra t'u̱ka tsu̱tui ja ya t'u̱ka jnini, nuyu̱ to'o mi b'e̱pi da t'o̱t'e ngu nuni Xalapan, Tlaxcalan, Tehuantepec, Oaxaca neje mar'a ya bo̱najmu mar'a ya t'u̱ka jnini jabu̱ bi guat'i ya nduste, ya dumantjuju dega k'astaboja, ge ya tjuju ya kristiano [...]"	"ne njabu̱ bri t'ot'e neje ko mar'a ya bo̱najmu mi pe̱tsi ra t'u̱ka tsu̱tui ja ya t'u̱ka jnini, nuyu̱ to'o mi b'e̱pi da t'o̱t'e ngu nuni Xalapan, Tlaxcalan, Tehuantepec, Oaxaca neje mar'a ya bo̱najmu mar'a ya t'u̱ka jnini jabu̱ bi guat'i ya nduste, ya dumantjuju dega k'astaboja, ge ya tjuju ya kristiano [...]"
"ne nu'a ri däme, pu̱ ñ'a'i, nugi ga ma ga tsogi'i nuni Cuetlachcoapan [n'a ra jnini nuni puebla],"	"ne nu'a ri däme, po̱ ña'i, nugi ga ma ga tsogi'i nuni Cuetlachcoapan [na ra hñä nuni Puebla],"
"ne nu'u̱ bi mani dra ts'okat'o̱t'amfeni nuni Michoacán, Xalisco, Culhuacan ne nuni neje Pánuco, ne nuni Oaxaca, Tehuantepec ne Guatemala, ne nuua ra r'ayo majyati, nub'u̱ bri t'o̱t'a ra mabagi pa dra uadi dra t'o̱t'a nu'a ra ts'okat'o̱t'amfeni inda tsogije se̱je̱."	"ne nu'u̱ bi mani ra ts'okat'o̱t'amfeni nuni Michoacán, Xalisco, Culhuacan ne nuni neje Pánuco, ne nuni Oaxaca, Tehuantepec ne Guatemala, ne nuwa ra r'ayo majyati, nub'u̱ bri t'o̱t'a ra mabagi pa ra uadi ra t'o̱t'a nu'a ra ts'okat'o̱t'amfeni nda tsogije se̱je̱."
"nejege'a ra ngätsi. mi jä ya mpe̱fi dega mabagi,ya nkjom'a te ne ya fu̱nbo̱kja, inte ma mahuai mi jä ni ge'a ya bu'bai."	"ne jege'a ra ngätsi. mi jä ya mpefi dega mabagi, ya nkjom'a te ne ya funbokja, inte ma mahuai mi jä ni ge'a ya bu'bai."
njabu̱ bi bo̱nga dega xui. mra ngo nub'u̱ ra Tecuílhuitl bi bo̱nga: nub'u̱ bi kja ya du ja ra r'ani ra deje ya u̱erna.	ñabü bi mbonga dega xui. mra ngo nub'ü ra Tecuílhuitl bi mbonga: nub'ü bi hña ya tu ja ra rani ra teje ya üerna.
"nub'u̱ bi tjandi ra Tzihuacpopoca, bi t'ena:"	"nub'ü bi txandi ra Tzihuacpopoca, bi t'ena:"
"nub'u̱ ya ñämfo̱ bi jandi ge xa ñ'eje nubu̱ da tsu̱di, ge mi tekuabi ra nest'iji, m'estjo bi munts'i bi miji ya mahuai."	"nub'ú ya ñämfo̱ bi xandi ge xa ñ'ethe nubu̱ da tsu̱di, ge mi tekuabi ra nest'iji, m'estho bi munts'i bi miji ya mahuai."
"nuna kjä'i inbi tsa bi tjädi makjuäni nu'a ra nt'ani. ingra nge'a nuya pa bi jneki n'a ra jyoya jä'i ra macehual (hombre de pueblo),"	nuna kää'i inbi tsa bi tädi makyuäni nu'a ra nt'ani. ingra nge'a nuya pa bi jneki n'a ra yoya jä'i ra masehual.
"nuna nte̱nga b'ede ja bri jat'i ra Tzihuacpopocatzin, bi o̱t'e da tjogi ge'a ra ts'e̱y'e̱jmu. inbi bo̱nga nuna nt'o̱t'e bi tsu̱diju̱ ko ma r'a ya b'e̱jni. ma ra ya ñ'ete inbi jopi da kju̱ man'aki ra ñ'u nuya ts'okate. pe nuya inbi joki ra b'ai."	"nuna nte̱nga b'ede ha bri hat'i ra Tzihuacpopocatzin, bi o̱t'e da jogi ge'a ra ts'e̱y'e̱jmu. inbi bo̱nga nuna nt'o̱t'e bi tsu̱diju̱ ko ma r'a ya b'e̱xni. ma ra ya ñ'ete inbi jopi da kju̱ man'aki ra ñ'u nuya ts'okate. pe nuya inbi joki ra b'ai."
"nuua di udije ra jñäpi bi nto̱t'e bi nkja ra agosto ra kje̱ya 1595, n'a ra kjä'i mra tjuju ra miguel Hernández, ra me Chiyauhtzinco,"	"nuä di uthije ra ñäpi bi nt'ot'e bi nkä ra agosto ra k'ei 1595, n'a ra k'äi mra t'utu ra miguel Hernández, ra me Chiyauhtzinco,"
nuya bo̱najmu ya mem'onda ñätsi bi ñäui ra Cihuacóatl Tlacotzin m'estjo bi tjädi:	nuya mbonañu ya me̱monda ñäts'i bi ñäwi ra Cihuacóatl Tlacotzin m'estho bi t'edi:
ra Tlacatécatl mra me Cuauhtitlan ne ra bktri ra mbot'a ngu bri kjapi ya tsat'yo bi zi.	ra Tlacatécatl mra me Cuauhtitlan ne ra bukuthri ra mbotha go hñäki ya tsatho bi zi.
ra doy'e̱ pajni xki njom'i ko ya chalchihuite.	ra doye̱ pahni xki ñomi ko ya chalchihuite.
"ra mu̱di ra Cuauhtémoc, ra jmu ra bondo, ra nyojo ra tlatsotzin, ra Cihuacóatl ra njñu ra oquiztzin, ra bo̱najmu ja ra nini ra aztsapotzaltso Mexicapan, ra ngojo ra panitzin, ra bo̱najmu nuni ra Ecatepec,"	"ra mudi ra Cuauhtémoc, ra hñu ra bondo, ra ñoju ra tlatsotzin, ra Cihuacóatl ra ññu ra oquiztzin, ra boñahñu ja ra nini ra aztsapotzaltso Mexicapan, ra ñoju ra panitzin, ra boñahñu nuni ra Ecatepec,"
"ra mu̱di ra pa mi o̱t'e ra ngo ra mäkime ra u, ra tjuju ra Huixtocihuatl"	"rra mudi rra pa mi othi rra ngo rra mäkime rra u, rra t'ot'u rra Huixtocihuatl"
ra nge'a bi mu̱ni ko ra mahuai ja ra xu̱tja nu'a to'o bi umbabi ra kji.	ra nge'a bi muni ko ra mahoi ya ra xutha nu'a to'o bi umbabi ra kji.
"ra nyojo, bi tjo ra ndä ra Nauhtla, mra tjuju ra Cohualpopocatzin."	"rra ñotho, bi tho rra nda rra Nauhtla, mra thuthu rra Xohualpopocatzin."
"unga ya ngue̱nda te ra ts'omu̱i mi bu̱'i ne mi kjapi da ntso̱m'i nuya macehualtin, nkjabu̱ mi tjutuabi ya kjä'i mi b'u̱i te ma za"	"ʉnga ya ngʉnda te ra ts'ombʉi mi bʉ'i ne mi kapi da ntsomb'i nuya masehualtin, nkabʉ mi tʃʉtʉabi ya kä'i mi bʉi te ma za"
"xib'u̱ bri fádi ge nuya je mi kja nuni ra Cuauhchichilco, ja Xaltocan; ge mi pttsi ya ndá."	"xib’ö bri fádi ge nuya hñäki migi kja nuni ra Cuauhchichilco, ja Xaltocan; ge migi ptsyë ya nda."
"xki mbo̱ni nubu̱ ra jyodi ra Cuehuecatitlan,"	"xki mboni nubu ra yodi ra Cuehuecatitlan,"
"xki tjete ra ixtlilxóchitl ne ra ku ra Cohuanacotzin ko ya je dega dänga ndä bi mu̱di da jäni ra joga ts'ofo ya evangelio,"	Xki tjete ra ixtlilxóchitl ne ra ku ra Cohuanacotzin ko ya hñe thega dänga ndä bi mu̱di da jäni ra hoga ts'ofo ya evangelio.
"ya dänga ñu̱ni nsafi, ya nsafi, ya mahuai, jangu nu'u̱ gatjo xki tagi mbo ja ra jñe."	"ya dänga ñu̱ni nsafi, ya nsafi, ya mahuai, hangu nu'u̱ gatjo xki tagi mbo ja ra jñe."
"bi o̱tuabi nu'a ra makja xki nk'ojni mra tjuju ra alonso ruiz, ge mi y'o nuni juamuxtitan (Huamuxtitlan) nuni ra jyodi guerrero."	"bi o̱tuabi nu'a ra makxa xki nk'ojni mra t'ot'u ra alonso ruiz, ge mi y'o nuni juamuxtitan (Huamuxtitlan) nuni ra hñudi guerrero."
"di pädi xajño nuna b'e̱fi neje yojo to'o di pädi da mpe̱fi da y'este nuya joga do majye̱gi ya xito, mra tjuju ra ambetz'ihuay."	"di pädi xañu nuna b'efi neje yojo to'o di pädi da mpefi da yeste nuya hoga do majyegi ya xito, mra tjuju ra ambetz'ihuay."
"dra tjoki ra nto̱de, ra ketzal dra b'e̱ nuni Coyohuacan."	"Dra tsoki ra nt'ode, ra k'etsal dra b'e nu̱ni Coyohuacan."
e mi r'ani dega xui ra Cihuacóatl g'ea mi zoni ne mı mafi.	e mi rani thega xui ra Cihuacóatl gea mi zoni ne mi mafi.
"ebu̱ bi gäi jabu̱ mi to̱ge ebu̱ bi yopa ma ja ra jnini ra Cuetaxtlan,"	"hñä bi gäi hñabu mi tho̱ge hñä bi yopa ma ja ra nxuni ra Cuetaxtlan,"
"ge'a ra mu̱di ra tjuju ra Hernando, ra nge'a nkjabu̱ mra tjuju ra takjä ra Cortés neje nkjabu̱ mra tjuju ra ndä Católico ne ra ku ra Cohuanacotzin bi tjutuabi ra Pedro po ra Pedro Alvarado ra nge'a ra takjä,"	"ge’a ra mudi ra t’ut’u ra Hernando, ra nge’a nkjabu mra t’ut’u ra takxä ra Cortés neje nkjabu mra t’ut’u ra nda Católico ne ra ku ra Cohuanacotzin bi t’ut’ubi ra Pedro po ra Pedro Alvarado ra nge’a ra takxä,"
"ma n'a mi b'ai nuni teotletso, jabu̱ ra ñ'u̱ pa manjuäntjo pa da zo̱ni nuni ra peñón (Tepetzinco)."	"ma n'a mi b'ai nuni teotletso, hñäbu ra ñ'u̱ pa manxuänt'o pa da zo̱ni nuni ra peñón (Tepetzinco)."
"mi tso̱jo̱ getbu̱ ra fu̱nga t'o̱jo̱, jabu̱ mi tjutuabi ""takjón ra nxu̱ni, nkjabu̱ bi jutuabi ya ndeznä ya b'e̱jnanoya bi pe̱jni ra ts'e̱y'e̱jmu, mi gu̱t'a ra ñ'u ra Tzihuacpopocatzin, bi bo̱nga ja ra ñ'u."	"mi tso̱ho̱ gethe̱bu̱ ra fu̱hnga t'o̱ho̱, hñabu̱ mi thothoabi ""takyon ra ñ'u̱ni, nthñabu̱ bi huthoabi ya ndeznä ya b'e̱hnaño ya bi pe̱hni ra ts'e̱y'e̱hmu, mi gu̱t'a ra ñ'u ra Tzihuacpopocatzin, bi bo̱nga ha ra ñ'u."
mra ku ra Cacamatzin mra bo̱najmu nuni Tetzcoco mri ñ'oui va kjä'i mi y'o mpaja.	mra ku ra Cacamatzin mra bonajmu nuni Tetzcoco mri ñ'oi va kä'i mi y'o mpaha.
"n'a ra nto̱de dega chalchihuite, xi m'et'e dega ze̱ka do, neje mi pe̱tsi n'a ra tsant'i de ga k'astabokja."	"n'a ra nt'ot'e thega chalchihuite, xi m'et'e thega ze̱ka do, neje mi pe̱tsi n'a ra tsant'i thega k'astabokja."
ne nduntji ya ambetz'ihuay ne mar'a joga do mi pe̱tsi ra mu'ui:	ne nt'unt'i ya ambäts'ihüi ne mar'a hoga do mi pëti ra mïhï:
neje n'a ya tje̱stji dega mboťahuaido.	ñehe ña ya tʸestʸi dega mbo̱tʸahoaido.
"nuna bi o̱t'a ra ntso̱m'i ra nge'a neje nuya ya b'e̱datsi bi tsini ko ra Cortés ne ra Cohuanacotzin ne ra ixtlilxóchitl xki nsofo pa ra ixtlilxóchitl da gu̱ka ya kjä'i ge mi zu ya jyodi, nkjabu̱ mi pe̱jna akjuä da t'o̱t'e."	"nuna bi o̱t'a ra ntsömi ra nge'a neje nuya ya b'ëdatsi bi ts'ini ko ra Cortés ne ra Cohuanacotzin ne ra ixtlilxóchitl xki nzofu pa ra ixtlilxóchitl da guka ya kjä'i ge mi zu ya yodi, nkjabu mi pëjna akjuä da t'ot'e."
"nuna nt'o̱t'e bi ntjandi xa nts'ogi njabu̱ bri tjutuabi, bi ena ge mra nzu̱te ko ma m'u̱jai ra nzu̱te ne mi tjutsuabi ko ya mpe̱bi dega mabagì, jabu̱ jmä ge n'a di ge'u̱ bi y'e̱nga n'a ra do, ko nge'a bi jyo, nu'u̱ mar'a ya b'e̱go ge mä ge nu'u̱ se̱je̱ ya ñämfo̱ bi jyo bi mu̱tu'a n'a ra mahuai ja ri ngati bi mu̱tuabi n'a ra nzu̱ni."	"nuna nt’ot’e bi nt’andi xa nts’ogi njabu bri txutuabi, bi ena ge mra nzute ko ma m’ujai ra nzute ne mi txutsuabi ko ya mpefi dega mabagì, jabu jmä ge n’a di ge’u bi y’enga n’a ra do, ko nge’a bi hño, nu’u mar’a ya b’ego ge mä ge nu’u seje ya ñämfo bi hño bi mutu’a n’a ra mahuai ja ri ngati bi mutuabi n’a ra nzuni."
"ra Cuauhtémoc, Tlacotzin, ra Cihuacóatl, Oquiztzin, Panitzin, Motelhuihtzin; nuna bi sofo ra tsortés nuni Coyoacan, nu'u̱ to'o mi pädi yojo ya jñäki ngu'a ra jerónimo aguilar ra malintzin."	"ra Cuauhtémoc, Tlacotzin, ra Cihuacóatl, Oquiztzin, Panitzin, Motelhuihtzin; nuna bi sofo ra tsortés nuni Coyoacan, nu'u̱ to'o mi pädi yojo ya jñäki ngu'a ra jerónimo aguilar ra malintzin."
t'ena ge ya macehual [ya kjä'i b'u̱i ja ra jyoya]	T'ena ge ya maza hñäki [ya kä'i b'ui ya ra ñoya]
"xki tjokuabi nuya jotjo ts'ints'u̱ mra tjuju ra ""tlauhquecho"" ne “tzinitzcan zacuan"","	"xki tjokua̱bi nuya hothó ts'ints'u̱ mra tjuju ra ""tlauhquecho"" ne “tzinitzcan zacuan”,"
-¿te be'a gi mä nu'i Cihuacóatl?	-¿tʉ be̱fi gi ma̱ nu'i Cihuacóatl?
"bi k'ajni ko ya dänga ñuni nzafi ne bi tjetse ko ya makahuai nuya otomi geb'u̱ bi japi bi b'e̱di, bi mä nuyu̱:"	"bi kaxni ko ya dänga ñuni nzafi ne bi tjetse ko ya makaxuai nuya hñäki ge'bü bi xapi bi bädi, bi mä nu'ü:"
da tjuts'i ya nkjot'ijñä ( )	da xuxi ya nkjot'iñä ( )
"da umbabije te da zi, da kjapabije nduntji ma zu."	"da umbabihe te da zi, da kyapabihe ndunt'i ma zu."
ebu̱ bi mä nuna b'e̱fi xa tjoki xajño bi kjohya ra ts'e̱y'e̱jmu.	Hä bä mä nuna b’efi xa txoki xañu bä k’oya ra ts’ey’ejmu.
"fernando alva ixtlilxóchitl, xiii nkjändajmä ""ra ñ'eje ya ñämfo̱ ne ra mu̱di ra joga ts'ofo ra evangelio."""	"Fernando Alva Ixtlilxóchitl, xingi nkänt'ä ""rra ñäjä ya ñä'ä hñäki ne rra mudi rra hoga ts'ofo rra evangelio."""
"ga kjuatiju̱ nu'a juts'i nkjani, ya ts'ojä'i, ra carranza, ge xa o̱t'a ya ts'okuate pa gekagiju̱; ga o̱t'e da nkja ra ts'e̱di ma munts' ne njabu̱ ga tsu̱diju̱ da nkja nu'a ra joga tsu̱tui, da nkja ra jai, ra jñegi ne ra joga ts'u̱tui;"	"ga kjuäti nu'a hutsi nkäni, ya ts'oyä'i, ra karransa, ge xa o̱tä ya ts'okuäte pa gekäjü; ga o̱ti da nkä ra ts'edi ma münts'i ne ñäbu ga tsüti da nkä nu'a ra hoga tsüti, da nkä ra häi, ra ñägi ne ra hoga tsüti;"
gatjo ya jyoyakjä'i mi b'u̱i ja ra jnini bi jandi.	Gatxu ya ñuñakä'i mi b'ui ja ra ñeni bi yandi.
"ja bi jäni ra ñ'udi, ma kjä'iju̱ bi ent'i gatjo majye̱gi nuya nzu̱te"	"xa bi jäni ra ñ'udi, ma kjä'iju̱ bi ent'i gatjo majyegi nuya nzute"
"ja n'aa nza̱tjo xudi ra pale berto, bi bo̱ni nda jyonga te nda nzimxidi ngetjo nda zi ya jme jyaxtjo mi u̱xa ya u, ua ngu mi nzäi mi nkajui yá jme nuya chukju̱ xa jogi ja nuya 'bomuja̱i nts'ät'i, nt'o̱kuä;"	"xa nää nzatjo xudi ra pale berto, bi boni nda yonga te nda nzimxidi nge̱tho nda zi ya hme yaxtjo mi uxa ya u, ua ngu mi nzä mi nkajui ya hme nuya chukju̱ xa jogi xa nuya 'bomuja̱i nts'ät'i, nt'okuä;"
"ja nubia di ndäki, di ndändiñäjmu, di ma ga ts'u̱tsa'i ri y'e, ga ndäne'i ra nge'a nu'a'i ma makjaje, ra bartolomé lópez, nub'u̱ mi nkjuäni ma b'e̱jña inbi nkjuäni ja nubu̱ mi xaxi pa da o̱t'a ya tso̱mfen"	"xa nuvia di ndäki, di ndändiñäjmu, di ma ga ts'u̱tsa'i ri y'e, ga ndäne'i ra nge'a nu'a'i ma makxaxe, ra bartolomé lópez, nu'b'u̱ mi nkjuäni ma b'e̱xña inbi nkjuäni xa nu'b'u̱ mi xaxi pa da o̱t'a ya tso̱mfen"
"ja ya t'u̱ka ze̱ki tjuts'i n'a tu̱kitjo nuna tjogi ge bi juxa ra fernando alva ixtlilxóchitl, nu'a b'e̱tsi ra xiiii nkjondajmä."	"Xa ya t'uka zege thuts'i n'a t'ukitho nuna thogi ge bi juxa ra Fernando Alva Ixtlilxóchitl, nu'a b'ëtsi ra xiiii nk'ondaxmë."
jabu̱ ga kju̱he nuyu̱ (ya tenochcas) te gi joniju̱?	xabu ga kju̱he nui (ya tenochcas) te gi honiju?
"jam'u̱ gatjo ya kjuän'ajmä ge nuua xa ze̱ti ri ñ'eje dige'a ya noya ya mu̱dimejai ja ra jñä ya ndeznä, nuna tjuju ri uni inga se̱je̱ ra n'atsanoya pa da fädi ra jñämfo̱, ingi ri me̱udi dige'a ra jmä fu̱oti dige'a nuna ra jñäki ra netzajualtsoyotl. ne ra cuauhtémoc."	"Jam'u̱ gattho ya kjuäñ'äjmë ge nuwa ha zëti ri ñ'eje dige'a ya noya ya mu̱dimehai ja ra ñä ya ndeznä, nuna t'ut'u ri uni inga sëjë ra ñ'atsanoya pa da fädi ra ñämfo̱, ingi ri me̱udi dige'a ra jmä hu̱oti dige'a nuna ra ñäki ra netsajualtsoyotl. Ne ra Cuauhtémoc."
mi jneki ngu ma kjä'iju̱ ngabu̱ mri jneki.	mi nxeki ngu ma kä'itu ngapu mri nxeki.
"nduntji bri kjojya, bri tjuxpabi gatjo nu'a mi o̱t'abi ra b'edi, ko nge'u̱ bi m'u̱i ne mi t'umbabi ya t'ixu:"	"ndunt'i hñäki k'uiya, hñäki xuxpabi gato nu'a mi o̱t'abi ra b'edi, ko nge'u̱ bi m'u̱i ne mi t'umbabi ya t'ixu:"
"ngu mra me̱ti, nu'a r'a hyodi, jabu mi y'o, n'a ngu n'a mi kjohya mi mfe̱m'a xinxi xi mi kjohya ya ndäte, mi tjede n'a ngu n'a mi jñu̱fi ne mi fe̱m'a ya xinxi: xi mi b'u̱i mpaja."	"ngu mra met'i, nu'a r'a hiothi, hñabu mi y'o, n'a ngu n'a mi kyohya mi mfe̱m'a hinthi xi mi kyohya ya ndäte, mi t'ede n'a ngu n'a mi ñ'ufi ne mi fe̱m'a ya hinthi: xi mi b'ui mpaha."
"nkjabu̱ ri ñ'eje ya kje̱ya inda m'e̱di, inda mpumfri, ga nzäi ga pe̱tsi nugagiju̱ ja ma mfeniju̱, ga pe̱tsi nugagiju̱, ra bätsi dige'u̱, ya b'e̱to, ya ntsaniku, ya mbänga b'e̱to ne to'o dra ñ'epu̱, to'o majye̱gigiju̱, ma kjiju̱, ya ku̱ju̱."	"nkjabu̱ ri ñäjä ya kje̱ya nda m'e̱di, nda mpumfri, ga nzäi ga pe̱tsi nugagiju̱ ja ma mfeniju̱, ga pe̱tsi nugagiju̱, ra bätsi dige'u̱, ya b'e̱tho, ya ntsaniko, ya mbänga b'e̱tho ne to'o ra ñ'epu̱, to'o majye̱gigiju̱, ma kjiju̱, ya ku̱ju̱."
"nu xä otj'u̱, ma gä ñ'kjäju̱"	"nu xä otj'u, ma gä ñ'kjäju"
"nuga̱ xi di ne'i, jindi pädi jankja..."	"nuga̱ xi di ne'i, hñäki pädi hankja..."
"num'u̱ di kjojyaju̱, nkueju̱, nts'o̱miju̱, tsuju ne pa da t'o̱xkäju̱ di jojñu̱ nu ya nt'u̱i xi di 'yooju̱ (¡!). nuya da nt'ot'i ko ra dänt'ot'í"	"num'hu̱ di kjojyaju̱, nkuehu̱, nts'o̱mihu̱, tsuhu̱ ne pa da t'o̱xkähu̱ di hñoñhu̱ nu ya nt'u̱i xi di 'yoho̱ (¡!). nuya da nt'ot'i ko ra dänt'ot'i"
"nuna bi kjojya ja ra mabagi,"	"nuna bi k’oiya hña ra mabaki,"
"nuya jñu o gojoya pa bi b'u̱i nubu̱ bi xitsuabi ra kjäpadeje nduntji ya kjä'i, ngu xa t'ena."	"nuya ñu o gohoya pa bi b'ui nubu bi xitsuabi ra käpädehe ndunt'i ya kä'i, ngu xa t'ena."
"nuya tsat'io mi b'et'o, mi gu̱t'a ra ñ'u, mi teni, ya xiñu mi kju̱ts'i pa mañä, xi mi päjä gatjo mi jandi mi nest'iji: mi tu̱ta ya kjijni"	"nuya tsat'i yo̱ge b'et'o, yo̱ge gu̱t'a ra ñ'u, yo̱ge teni, ya xiño yo̱ge kju̱ts'i pa mañä, xi yo̱ge päjä gatjo yo̱ge jandi yo̱ge nest'iji: yo̱ge tu̱ta ya kjijni"
"pe, nu'i ndada nu'i ma t'ek'ei ra makja, nub'u̱ nu'i ingi zugagije, ¿jankja, nuua, ra jyo di ge'a, ga tsogi nubu̱ [nu'a ma b'e̱jña]?"	"Pe, nu'i ndada nu'i ma t'ek'ei ra makxa, nub'ux nu'i ingi zugagixe, ¿jankxa, nuwa, ra jyo di ge'a, ga tsogi nub'ux [nu'a ma b'e̱xña]?"
"r'a ya kjä'i mi b'u̱i ja ra ngumi kja nunu ja ra jnini ri mankjuäntjo pa da tsoni nubu̱ ra amáxac,"	r'a ya kä'i mi b'ui ya ra ngumi kä nunu ya ra ñüni ri manxuänt'o pa da tsoni nubu ra amájak.
"ra nge'a di o̱t'a nuna noya ra ts'u̱tui ne gatjo to'o da guat'a ja ma jyoje, nu'u̱ to'o da ne, da me̱tsi n'a ra joga m'u̱i ne da m'u̱i mankjuäntjä. ja nubu̱ xa mabu̱ ma noya ge di pe̱tsi ra tsa, dega joga kjä'i ne dega jogat'o̱t'antujni"	"ra nge'a di o̱t'a nuna noya ra ts'u̱tui ne gatjo to'o da guat'a ja ma jyoje, nu'u̱ to'o da ne, da me̱tsi n'a ra hoga m'ui ne da m'ui manxuänt'ä. ja nubu̱ xa mabu̱ ma noya ge di pe̱tsi ra tsa, dega hoga kä'i ne dega hogat'o̱t'antuini"
ra ngejna nuna pa bi ma n'a ra ñ'u mankjuäntjo.	ra ngejna nuna pa bi ma n'a ra ñ'u mankjuäntjo.
"ra njñu ne ra ngästsi ra b'ist'ofo di juts'iju̱ ja nuna ze̱ki b'ist'ofo, ri ñ'eje ra vii nkjondajmä ra chimalpain,"	"ra ñʞu ne ra ngäts'i ra b'ist'ofo di huts'iju̱ ha nuna ze̱ki b'ist'ofo, ri ñ'ehe ra vii nkondaxmä ra chimalpain,"
"ra ntjädi ra cuitlahuacatzin bi ena ge ina da o̱t'e nuya bi b'e̱pabi ya nso̱jo̱kjä'i,"	"ra nt'ädi ra cuitlahuacatzin bi ena ge na da o̱t'i nuya bi b'e̱pabi ya nzokjä'i,"
"ra nyojo nu'a mi zu ra tepoztlan; ra njñu ra me tizatlan, ra nkjojo mi ñ'eje nuni huehuetlan ne ra nku̱ta mra dänga mictlan."	"ra ñotho nu'a mi zu ra tepoztlán; ra ñ'ño ra me tizatlán, ra ñotho mi ñ'eje nuni huehuetlán ne ra nk'uta mra dänga mictlán."
ri ñ'udi xajño nubia jankja beni ya metlaxcala bi do̱m'i mpaja nuya nso̱jo̱ kjä'i.	ri ñudi xañu Nubia hankya beni ya Metlaxcala bi do̱mi mpaha nuya nso̱ho kä'i.
"t'ena ge inbi unga mfädi pa gatjo ya kjä'i mi ñ'oui, ge nuna ndada ra marqués da ñ'eje dra jmu ja ma jaije, da ja me̱ti nu'a di pe̱tsije neje dra kjakagije ga mpe̱fije ra jai ge bi umbabi o bi jänbabi ya joga jai ya n'añ'o jnini."	"t'ena ge hñä unga mfädi pa gatjo ya kä'i mi ñ'oi, ge nuna ndada ra marqués da ñ'eje ra jmu ja ma jaije, da ja me̱ti nu'a di pe̱tsije neje ra kjakagije ga mpe̱hije ra hai ge bi umbabi o bi jänbabi ya hoga hai ya ñ'añ'o hñini."
"xi mi taxki ra ñ'u, imbi tsa da r'anga n'a, jo̱nse̱je̱ mi taxka n'a ja ra bo̱jai. ya y'ofadi mi kju̱t'atjo."	"xi mi taxki ra ñ'u, imbi tsa da r'anga n'a, jonsëjë mi taxka n'a ja ra mb'ojai. ya y'ofadi mi kjut'atjo."
"ya dänga mfu̱nga bo̱kjä bi ntjo, bi kot'i ko ya majkjuai, mi zu̱m'i neje ko ya t'e̱nga ts'u̱t'abo̱kja."	"ya dänga mfu̱nga bo̱xkjä bi ntjo, bi kot'i ko ya majkjuai, mi zu̱m'i neje ko ya t'e̱nga ts'u̱t'abo̱xkja."
ya r'atsanoya ra sajagún mi mä jankja mi yopa tsini. ya ndeznä bi nkoji inda ñ'udi. mi jatatjo pa bi mu̱di ra ntujni	ya r'atsanoya ra sajagún mi mä hankxa mi yopa tsini. ya ndezna bi nkoji nda ñ'udi. mi jatatjo pa bi mu̱di ra nt'ut'uni
"ya zi b'e̱jña mi ägi ja ya b'a ne ja ya ngo̱de, nuya ñ'o̱jo̱ mbo ja ya ne, ja ya nkjom'ajudi."	"ya hñäki b'ëxña mi ägi ja ya b'a ne ja ya ngode, nuya ñ'otho mbo ja ya ne, ja ya nkjom'ajudi."
"bi boxro xi 'be̱ts'ina, bido'u̱ ro 'yu̱ni 'na, xi bi bo̱x ro hkjua 'na, bido'u̱ ro ts'ii 'na, xi bo̱xro ts'äre 'na. ge'bu̱ go min pu̱n doja 'na."	"bi boxro xi 'be̱ts'ina, bido'u̱ ro 'yu̱ni 'na, xi bi bo̱x ro hñä 'na, bido'u̱ ro ts'ii 'na, xi bo̱xro ts'äre 'na. ge'bu̱ go mïn pu̱n dojä 'na."
bi ma mankjuäntjo jabu̱ mi b'u̱i ra ts'e̱y'e̱jmu bi xipabi;	bi ma manxjuänt’o hñä mi b’ui ra ts’ei’e’jmu bi xipabi;
bri kjuajni po nuya dra jmu.	B'ri kjuäni po nuya ra jmü.
"di to̱m'ihe ra ñ'etji pa nugagije, n'a ra pa ngu ma n'a ra pa tjogi nekagije di juadije ra nge'a indi tse̱tije nuna b'u̱i t'o̱t'e ko ngekagije man'año ya ntjo, t'e̱nts'igije tji ma jaije ma me̱tije, ju̱kagije ga mpe̱fije nduntji, b'e̱kagije ga jut'ije xduntji ya bokja, n'a ngu n'a ra pa nuna nkjut'i di o̱t'eje man'a te ma tjaije di tuje."	"di tom'ihe ra ñ'et'i pa nugakxe, n'a ra pa ngu ma n'a ra pa txogi nekakxe di juadi ra nge'a indi tset'i nuna b'ui t'ot'e ko ngekakxe man'año ya nt'o, t'ents'ikxe tji ma haixe ma met'i, jukakxe ga mpef'i ndunt'i, b'ekakxe ga jut'i xdunt'i ya bokxa, n'a ngu n'a ra pa nuna nkjut'i di othe man'a te ma tjaixe di tu."
gatjo nuna jai ja nuna r'ayo ximjai nkjabu̱ bi tjutuabi nuya nso̱jo̱jä'i inbi tsa bi tjutuabi man'a ra tjuju.	gatho nuna hai ya nuna rayo ximhäi nkäbu̱ bi chuchuabi nuya nzonzonjai inbi tsa bi chuchuabi man'a ra chuchu.
"ja mi tso nde, bi mu̱di bi nkja n'a ra jneki ngu nkjagiju̱ dega kjä'i, bi t'ot'e ra b'ai ngu dega kjä'i,"	"xa mi tso nde, bi mudi bi nxja n'a ra nxeki ngu nxjagiju dega kä'i, bi t'ot'e ra b'ai ngu dega kä'i,"
"ma bo̱najmu'ije: nuna b'e̱fi ga tsokagije sta kjuatihe gatjo: gi nuti nuua, xa jño bo̱najmu."	"ma mbonañmu'ixe: nuna b'efi ga tsokaxeje sta kjuathihe gatjo: gi nut'i nuwa, xa ño mbonañmu."
"mi mä dega ts'e̱dira jñä tso̱pu da ts'o̱jo̱bu nuya nzo̱jo̱kjä'i ga jandiju̱ te ma ts'e̱di pe̱tsi, ra nge'a ma akjuä ra quetzalcohuatl b'u̱i nuua ko ngekagiju̱,"	"mi ma dega ts'edirä ñä tso̱pü tha ts'o̱ho̱bü nuya nzohokjä'i ga xandiju̱ te ma ts'edi pe̱tsi, ra nge'a ma akjuä ra quetzalcohuatl b'u̱i nuä ko ngekagiju̱,"
"ne ya nt'u̱i, jankja di tjuts'i ya nt'ofo, nkjap'u̱ neje mä 'ra ya mpeu̱i da fats'i di nt'ot'i ra jñäjñu"	"ne ya nt'ui, hankja di txuts'i ya nt'ofo, nkap'u neje ma 'ra ya mpeui da fäts'i di nt'ot'i ra ñäñu"
"nub'u̱ nu'i ingi kjapi da bo̱nga nu'a ra makja ja nu'a ra jnini, ¿jankja ra yotui, ga tso̱gi nubu̱ ma b'e̱jña? o̱t'a r'ato ya kje̱ya bi mu̱di [ra makja ra bartolomé lópez]"	"nub’ú nu’i hingi xapi da mbonga nu’a ra maki ya nu’a ra ñeni, ¿jankya ra yot’i, ga tsogi nub’ú ma bäxña? otho rato ya kjea bi mudi [ra maki ra Bartolomé López]"
pa ga b'u̱i mpaja ne ga o̱t'e n'a ra nkjondajmä gatjo nu'a ga jandi.	Pa ga b'ui mpaha ne ga o̱t'e n'a ra nkjondaxmi gatjo nu'a ga handi.
"r'a nuna mi ntjandi ngu nu'a ma tjänkjuaju̱ (ychtlilmatli), xi mra nts'o, mi kuet'e ja ya ngo̱,"	"r'a nuna mi nt'andi ngu nu'a ma txäñkjuäju̱ (ychtlilmatli), xi mra nts'o, mi kuet'e ja ya ngö,"
"xa zägi mpaja, nub'u̱ xa nkjabu̱ xa kjapabi ma zu ne inte xa t'o̱tuabi nub'u̱ inda kjapi xa po̱jo̱ bi ya kue̱ ra nge'a ya kjä'i xi mra no̱t'e ne mra jyotekjä'i,"	"ja zäki mpaha, nu'bü ja njabu̱ ja khapabi ma zu ne inte ja t'otabi nu'bü inda khapi ja po̱ho̱ bi ya kue̱ ra nge'a ya kä'i xi mra no̱t'e ne mra yotekä'i,"
"y'o, ri ma ne gi xipabiju̱ ya metlaxcala ge ma r'a ya me̱ti kjä'i ne ri ajuäju̱, ge nu'a ga mä ge xa eje nuua ma jaiju̱, ge di umbabije ma ntjädije."	"yo, ri ma ne gi xipabixu ya mexitlaxkala ge ma ra ya meti kähñi ne ri ahuäxu, ge nu'a ga mä ge xa eje nuwa ma haixu, ge di umbaxije ma nt'ädije."
¿te da o̱t'e ma kjä'iju̱ sta b'e̱diju̱?	¿te da o̱t'e ma kyä'iju̱ sta b'e̱di?
"-da ts'iua:... ri ñ'eje ge'a ma nkjueij'u̱. da o̱t'eje ya ñ'o̱te ko ya je̱m'i, ya ñ'o̱t'eje ko ya ntuts'i. da o̱ts'e̱ ra b'e̱na noya."	"-da ts'iba:... ri ñäjä gä'a ma nkjueij'u̱. da o̱t'ejä ya ñ'o̱the ko ya jämi, ya ñ'o̱t'ejä ko ya nt'uts'i. da o̱ts'e̱ ra bäna nuya."
-dom'i ma akjuäju̱ ge inda yu̱t'a ja ma nguju̱ nuju̱ to'o e̱nts'i pa tji ne da jokuabi ra jonanjyo nub'u̱ sta ne da jyoki ya inda za.	-dom'i ma akjuäju̱ ge hñä yu̱t'a ja ma nguju̱ nuju̱ to'o e̱nts'i pa tji ne da jokuabi ra jonanjyo nu'bü̱ sta ne da jyoki ya hñä za.
"-o̱t'a ra mäte gi o̱deju̱, kja gi b'ai nuuaju̱. mont'a ya ngo akjuä; ri kjuat'i ra ngo ga tsunda ma akjuäje."	"-ot'a ra mäthe gi othehu, hñäki gi bädi nuähu. mbonthä ya ngoa akjuä; ri kjuat'i ra ngoa ga ts'ünt'a ma akjuähe."
"-xa jño, di b'u̱ije nkjamädije."	"Xa ñä, di b'uiye nkamadiye."
-¿nguande nkjabu̱ ga mäu gra kjuäju̱?	-¿Nguande nkahmu̱ ga mäu ra kjuäju̱?
"-ñ'emabagi, ya gabida, ya kjä'iju̱ gi pädi ra ntuni ra mem'onda ba ejeju̱ ga te̱niju̱ma nzu̱teju̱. ko ya mätsa mi te̱je̱, ko ya bu̱'bai ko ngatjo ra ts'e̱di mi te̱je̱ ra ñ'u."	"Ñ'emabaxi, ya gabitha, ya kä'i hño gi pädi ra nt'uni ra me'monda ba ejehu ga t'eni hñuma nzuthehu. Ko ya mätsa mi t'ehe, ko ya bu'bai ko ngatho ra ts'edi mi t'ehe ra ñ'u."
"bi tse̱ti nuna ngot'i ra m'onda, ngu pede ra dänga b'ede, ya k'oi ne ya nkjändajmä, ngu nu'a ra jmä ra alonso axayaca, gojo n'ate ma pa bi nzo̱t'e nuna pa."	"bi tsëti nuna ngot'i ra m'onda, ngu pëthe ra dänga b'ede, ya k'oi ne ya njändaxmë, ngu nu'a ra jmë ra alonso axayaca, goxu n'ate ma pa bi nzot'e nuna pa."
"into y'o mankjuäntjo, into pa ri nektjo."	"NTU y'o mankjuänt'o, NTU pa ri nekt'o."
"nub'u̱ ndi umbabije ma nkjut'ije xki nzäi ndi da'ije, mi adi n'a tu̱ki neje nub'u̱ ndi unije ya k'astaboja mi jäni made n'a tu̱ki [...]"	"nub'ú nthí umbabihe ma nkjot'ihe xki nzä nthí da'ihe, mi adi n'a túki neje nub'ú nthí unihe ya k'astaboha mi jäni made n'a túki [...]"
"ya miñ'o ko ngejna jmä ri kjojya,"	"ya miñ'o ko ngehna jmä ri kjojya,"
bi tso̱jso̱ ra ngo ma akjuäju̱: nubia da fu̱di da guadi ra r'e̱t'a ra pa.	bi tsojso ra ngo ma akjuäju: nubia da fudi da gwadi ra r'et'a ra pa.