Input	Result
"-pasadores: ""ya nts'äza xi mra nts'u̱t'i mi t'e̱ni ko n'a ra t'e̱nga ts'u̱t'a bo̱kja mi tjutuabi ra ballesta""."	"-pasadores: ""ya nts'äza xi mra nts'u̱t'i mi t'e̱ni ko n'a ra t'e̱nga ts'u̱t'a bo̱ja mi tjutuabi ra ballesta"""
"cantares mexicanos, biblioteca nacional de méxico, ya nt'ofo 1628 bis, folio 16 v."	"cantares mexicanos, biblioteca nacional de méxico, ya nt'oho 1628 bis, folio 16 v."
"ebu̱ bi bo̱ni, bi meui nuni nonohualco, ja ra ngu ra b'ongui jabu̱ ra gabida ne ra malintzin ne ""ra jyadi"" (alvarado) ne ra sandoval."	"ebu̱ bi bo̱ni, bi meui nuni nonohualco, ha ra ngu ra b'ongui jabu̱ ra gabida ne ra malintzin ne ""ra hyadi"" (alvarado) ne ra sandoval."
gi jandi ra nt'ofo ra tjuju ra crónicas de la conquista	gi handi ra nt'oho ra thuju ra crónicas de la conquista
"guzmán. ja ya je̱m'i b'e̱tsa kje̱ya manteb'u̱ di ge nuua m'onda ne ya jyo, nu'a ra jmä ra 12-conejo (1530) ge xa jmä ge xibú bi yut'i ja ra culhuacan ya ndeznä, nda pablo xochiquetzin, motelchiuhtzin ne ra guzman."	"guzmán. ha ya hem'i b'etsa kheya manteb'u̱ di ge nuua m'onda ne ya jyo, nu'a ra hmä ra 12-conejo (1530) ge xa hmä ge xibú bi yut'i ha ra culhuacan ya ndeznä, nda pablo xochiquetzin, motelchiuhtzin ne ra guzman."
"ja ga ñ'udiju̱ ra nt'ofo ya ñämfo̱ po ra ntjuts'i ra doctor garibay,"	"ha ga ñ'udihú ra nt'oho ya ñämfo̱ po ra ntjuts'i ra doctor garibay,"
ja nu'a jyodi nubia tjutuabi ra san martin.	ha nu'a hyodi nubia tjutuabi ra san martin.
"je̱mi unga mfädi ja ra t'u̱ka jnini jabu̱ b'u̱i ya kjä'i teni ra división ra arenas, 27 ra abril ra kje̱ya 1918, ra m'ets'a je̱m'i ra zapata, b'e̱tsi ja ra universidad nacional autónoma de méxico, expediente 29."	"he̱mi unga mfädi ha ra t'u̱ka hnini habu̱ b'u̱i ya jä'i teni ra división ra arenas, 27 ra abril ra kje̱ya 1918, ra m'ets'a he̱m'i ra zapata, b'etsi ha ra universidad nacional autónoma de méxico, expediente 29."
"m'e̱fa ja ra jñuti bri tjätuabi na ra jñe xki tagiri mo̱te, neje bri kjom'a ra xu̱tja ko n'a ra t'axa dutu mra tjujuu ra ""campanillante""."	"m'e̱fa ha ra jñuti bri thätuabi na ra jñe xki tagiri mo̱te, nehe bri jom'a ra xu̱tja ko n'a ra t'axa dutu mra thujuu ra ""campanillante""."
"ma dada'ije gra ts'u̱tui, di ne gi pädi ge ma me̱t'o instä tjogije nuna tjogi gatjo ya mapa xki r'ani, bi kjuat'i ko ngeke nu̱'u ri b'e̱go, ri me̱fi ya ñämfo̱, ra nge'a makjuäni ra hernando cortés ra ndä gabida,"	"ma dada'ije gra ts'u̱tui, di ne gi pädi ge ma me̱t'o instä thogije nuna thogi gatjo ya mapa xki r'ani, bi juat'i ko ngeke nu̱'u ri b'e̱go, ri me̱fi ya ñämfo̱, ra nge'a majuäni ra hernando cortés ra ndä gabida,"
mi b'u̱i ya mu̱dimejai mi ñä ra ndeznä ne jabu̱ ra jnini dige'a gatjo ra nxiki m'onda ngu r'a ya yaqui b'u̱i nuni sonora ne ya maya ri ñ'eje nuni yucatán ra nge bi guat'i ja ra tujni bi nkja nuua m'onda fädi ko ra tjuju ra revolución mexicana ya kje̱ya 1910-1919.	mi b'u̱i ya mu̱dimehai mi ñä ra ndeznä ne jabu̱ ra hnini dige'a gatho ra nxiki m'onda ngu r'a ya yaqui b'u̱i nuni sonora ne ya maya ri ñ'ehi nuni yucatán ra nge bi guathi ha ra tujni bi nkja nuua m'onda fädi ko ra thuju ra revolución mexicana ya kje̱ya 1910-1919.
mi fo̱tuabi ya ts'u̱tnibo̱kja mi tjutuabi ya jñämfo̱ ra pasadores neje ya bo̱zna ko ya nzafi.	mi fo̱tuabi ya ts'u̱tnibo̱kja mi tjutuabi ya jñämfo̱ ra pasadores nehe ya bo̱zna ko ya nzafi.
"n'a nt'udi di ge'a nuya ntjoki bri t'o̱t'e ja ya jñä ya ndeznä ra ngätsi ra ntjebe nkje̱ya ra r'e̱t'a ma gu̱to (s. xix), r'a ya jnini ngu ra xicontepec (villa juárez) nuna jyodi koji nuni puebla."	"n'a nt'udi di ge'a nuya ntjoki bri t'o̱t'e ha ya jñä ya ndeznä ra ngätsi ra ntjebe nkje̱ya ra r'e̱t'a ma gu̱to (s. xix), r'a ya jnini ngu ra xicontepec (villa juárez) nuna jyodi koji nuni puebla"
"n'a ra t'axa dutu mi pe̱tsi ya k'oi ra ixki, nuna mra tjuju jñämfo̱ ""campaneante resonador""."	"n'a ra t'axa dutu mi pe̱tsi ya k'oi ra ixki, nuna mra tjuju jñämfo̱ ""campaneante resonador"""
"ne ri mpe̱fi ja ra dängan gu nt'udi ra tjuju ra facultad de estudios superiores, acatlán, unam,"	"ne ri mpe̱fi ha ra dängan gu nt'udi ra tjuju ra facultad de estudios superiores, acatlán, unam,"
"ntjandi gatjo nu'a ra munts'i ra tjuju jñämfo̱ ra globalización ge 'a po̱ts'e dega nest'iji, nuna y'o̱te to̱m'i da nkja ra ntjo̱mäte."	"ntjandi hatjo nu'a ra munts'i ra tjuju jñämfo̱ ra globalización ge 'a po̱ts'e dega nest'iji, nuna y'o̱te to̱m'i da nkja ra ntjo̱mäte."
"nu'a ma r'a ya kjä'i mi pädi nuña b'e̱fi bri b'e̱pabi xa jyoki yojo ya mpe̱fi mi fädi ko ra tjuju ra amosqueador ko ya xi ya ts'ints'u̱ xi sta jotjo, gi jutsuabi made dige'a n'a ra zänä dega k'astabokja"	"nu'a ma r'a ya jä'i mi pädi nuña b'e̱fi bri b'e̱pabi xa johi yojo ya mpe̱fi mi fädi ko ra thuju ra amosqueador ko ya xi ya ts'ints'u̱ xi sta hotjo, gi jutsuabi made dige'a n'a ra zänä dega k'astaboja"
"nu'a ra munts'a kjä'i bi te̱ni bi zipabi man'a ya b'ede, mi t'ena ge ya kjä'i xki b'u̱i nubu̱ inbi pe̱tsi ra ts'e̱di nu'a mi mä pe m'e̱fa bi kjapi bi nxaxni ya tsu̱tui ne n'a ra diputado mi pe̱tsi ra mfeni xki kot'i mra tjuju ra josé maría lozano, bi y'onga ra jmä pa mar'a ya ñ'oui bi nxanxi: ""ri mo̱te ra tjits'i mi udi ra emiliano zapata, neje bri fädi ngu ra atila nuna bri nkju̱tsi [...] nu'a bi fädi ngu mi je̱gi ya b'e̱go ne'a bi mä da uni da nkja pa gatjo, ingi kjot'i [...]"	"nu'a ra munts'a jä'i bi te̱ni bi zipabi man'a ya b'ede, mi t'ena ge ya jä'i xki b'u̱i nubu̱ inbi pe̱tsi ra ts'e̱di nu'a mi mä pe m'e̱fa bi japi bi nxaxni ya tsu̱tui ne n'a ra diputado mi pe̱tsi ra mfeni xki kot'i mra tjuju ra josé maría lozano, bi y'onga ra jmä pa mar'a ya ñ'oui bi nxanxi: ""ri mo̱te ra tjits'i mi udi ra emiliano zapata, nehe bri fädi ngu ra atila nuna bri nkju̱tsi [...] nu'a bi fädi ngu mi he̱gi ya b'e̱go ne'a bi mä da uni da nkja pa gatjo, ingi jot'i [...]"
nu'u̱ to'o ñä ra ndenzä ja r'e̱t'a ma r'at'o ya estados.	nu'u̱ to'o ñä ra ndenzä ha r'e̱t'a ma r'at'o ya estados.
"nub'u̱ ri m'e̱jni ne ri b'e̱go ya ñämfo̱ bi kjuat'i ko ngekagije ne bi tso̱jo̱ ra gabida ra tjuju ra hernán cortés, maske indi pädije ge gatjo da za da o̱t'e ne xi ra nzunda maría trinidad,"	"nub'u̱ ri m'e̱jni ne ri b'e̱go ya ñämfo̱ bi juat'i ko ngakagije ne bi tso̱ho̱ ra gabida ra tjuju ra hernán cortés, maske indi pädije ge gatjo da za da o̱t'ehu̱ ne xi ra nzunda maría trinidad,"
"nubia, unga mfädi ja ra ñäjñu kjamädi ra universidad autónoma del estado de hidalgo."	"nubia, unga mfädi ha ra ñäjñu jamädi ra universidad autónoma del estado de hidalgo."
"nugi, ra miguel hernández ge di pe̱tsi ma ngu nuni chiyauhtzinco, ko ra t'ek'ei di udi ko nge'i, nuna m'e̱jnant'ofo di joki go tso̱n'i ko nge'i, ma t'ek'ei bo̱najmu'i nda doctor alonso ruiz, ra nk'ojnate ge gi b'ui nuua ja ra jnini ra quamochtitla."	"nugi, ra miguel hernández ge di pe̱tsi ma ngu nuni chiyauhtzinco, ko ra t'ek'ei di udi ko nge'i, nuna m'e̱jnant'ofo di joki go tso̱n'i ko nge'i, ma t'ek'ei bonahmu'i nda doctor alonso ruiz, ra nk'ojnate ge gi b'ui nuua ha ra jnini ra quamochtitla."
"nuna je̱m'i bri t'unga mfädi ko ra t'u̱ka ntjint'ant'ofo po ra marcelo díaz salas ne ra luis reyes garcía ja: tialtocan, revista de fuentes para el conocimiento de las culturas indígenas de méxico, vol. vi, 1970, b'ede ra 3, pp. 193-212."	"nuna hem'i bri t'unga mfädi ko ra t'u̱ka ntjint'ant'ofo po ra marcelo díaz salas ne ra luis reyes garcía ha: tialtocan, revista de fuentes para el conocimiento de las culturas indígenas de méxico, vol. vi, 1970, b'ede ra 3, pp. 193-212."
"nuna jñäpi juts'i ja n'a ra je̱m'i fädi ra derecho canonigo ko ra tjuju jñämfo̱ ngu ra ""solicitación al administrar el sacramento de la confesión""."	"nuna jñäpi juts'i ha n'a ra hem'i fädi ra derecho canonigo ko ra thuju jñämfo̱ ngu ra ""solicitación al administrar el sacramento de la confesión""."
"nuna m'e̱jna nt'ofo b'e̱tsi ja ra archivo histórico nacional, madrid, documento 165. bi unga mfädi ja ra nt'ofo ya zubi po ra y'ofo ra tjuju ra arthur j. o. anderson et al.: byond the codices: the nahua view of colonial mexico, berkeley, university of california press, 1976, pp. 181-187."	"nuna m'e̱hña nt'oho b'e̱tsi ha ra archivo histórico nacional, madrid, documento 165. bi unga mfädi ha ra nt'oho ya zubi po ra y'ofo ra thuhu ra arthur j. o. anderson et al.: byond the codices: the nahua view of colonial mexico, berkeley, university of california press, 1976, pp. 181-187."
"nuna nt'ofo b'e̱tsi ja ra archivo general de indias, sevilla, audiencia de méxico 168, bi unga dra fädi po ra miguel león-portilla ja cultura en peligro, méxico, alianza editorial mexicana, 1976, pp. 102-103."	"nuna nt'oho b'e̱hña ha ra archivo general de indias, sevilla, audiencia de méxico 168, bi unga dra hädi po ra miguel león-portilla ha cultura en peligro, méxico, alianza editorial mexicana, 1976, pp. 102-103."
"nuna pika je̱m'i kja te mä b'e̱tsi ja ra archivo general de la nación, nuua m'onda ne kja ja ra nduntji ya jnini, njabu̱ ngu ya nzaya nuni manjyati ne mar'a ya jnini, o̱t'e gi o̱de ra jñä ra mu̱dimejai."	"nuna pika hem'i kja te mä b'ehi ha ra archivo general de la nación, nuua m'onda ne kja ha ra nduntji ya hnini, njabu̱ ngu ya nzaya nuni manjyati ne mar'a ya hnini, o̱t'ehu gi o̱de ra jñä ra mu̱dimejai."
"nuua t'unga yojo ya jmä, kuän'ajmä ya ndeznä ne tjuts'i ja n'a ra k'oi mä mäkjuäni ri ntje̱ui n'a ya dänga ra tju̱ajmä manteb'u̱, nuua pede nu'a gatjo ya ts'otjogi bi y'o̱t'a dega fete ra alvarado."	"nuua t'unga yojo ya jmä, kuän'ajmä ya ndeznä ne tjuts'i ha n'a ra k'oi mä mäkjuäni ri ntje̱ui n'a ya dänga ra tju̱ajmä manteb'u̱, nuua pede nu'a gatjo ya ts'otjogi bi y'o̱t'a dega fete ra alvarado"
"nuua ya mu̱di noya ra motolinia, ja ra mu̱di nkoji bi t'o̱t'e ko ra tjuju ra tratado tercero ra dänga b´ede ya mu̱dimejai nuua r´ayo manjyati:"	"nuua ya mu̱di noya ra motolinia, ha ra mu̱di nkoji bi t'o̱t'e ko ra thuju ra tratado tercero ra dänga b´ede ya mu̱dimejai nuua r´ayo manjyati:"
"pa da t'unga mfädi gatjo nu'u̱ bi nkja, n'a di ge'u̱ ko ngu fe̱ti nu'a makjuäni mi joki mi tjutsuabi ya jnei ne ya b'ida. b'u̱i man'a ra mfädi da t'o̱t'a ra nt'udi, nu'a ra tjuju ""fe̱ta nu'a makjuäni bi nja nub'u̱ ra tsokat'o̱tamfeni (teatro de la conquista)""."	"pa da t'unga mfädi gatjo nu'u̱ bi nkja, n'a di ge'u̱ ko ngu fe̱ti nu'a makjuäni mi joki mi tjutsuabi ya jnei ne ya b'ida. b'u̱i man'a ra mfädi da t'o̱t'a ra nt'udi, nu'a ra tjuju ""fe̱ta nu'a makjuäni bi nja nub'u̱ ra tsokat'o̱tamfeni (teatro de la conquista)"""
"ra europa -mra nxika jai manteb'u̱, mi pe̱tsa n'a ra nxika b'ede-"	"ra europa -mra nxika hai manteb'u̱, mi pe̱tsa n'a ra nxika b'ede-"
"ra fernando ramírez mä ge nuna jyodi ri nge̱pu̱ jabu̱ kja n'a ra nikja ra san fernando ne ra ermita dige'a ya mártires dige'a san hipólito,"	"ra fernando ramírez mä ge nuna hyodi ri nge̱pu̱ jabu̱ kja n'a ra nikja ra san fernando ne ra ermita dige'a ya mártires dige'a san hipólito,"
"ra fernando de alva ixtlilxóchitl, fernando de, xiii relación: ""ra ñ'eje ya ñämfo̱ ne ra fu̱di ra nkanfri ra evangelio""."	"ra fernando de alva ixtlilxóchitl, fernando de, xiii relación: ""ra ñ'ehje ya ñämfo̱ ne ra hu̱di ra nkanfri ra evangelio""."
"ra kuän'ajma ra n luz jiménez bi juts'i ra fernando horkasitas bi unga mfädi ne bi r'atsi nuña jmä), de porfirio díaz zapata, memoria nábuatl de milpa alta, méxico, unam,, instituto de investigaciones históricas, 1974, p. 105"	"ra kuän'ajma ra n luz jiménez bi juts'i ra fernando horkasitas bi unga mfädi ne bi r'atsi nuña jmä), de porfirio díaz zapata, memoria náhuatl de milpa alta, méxico, unam, instituto de investigaciones históricas, 1974, p. 105"
"ra raymundo isidro alavez, bi b'u̱i'i nuni ra boxtha chico, san salvador, estado de hidalgo"	"ra raymundo isidro alavez, bi b'ui'i nuni ra boxtah chico, san salvador, estado de hidalgo"
"ra jmä ra fundación de santo tomás ajusco, archivo general de la nación, méxico, ramo de tierras vol. 2676, expediente. 4, archivo histórico de la biblioteca nacional de antropología, colección antigua, vol. 254, fojas 259 r.- 260 v."	"ra hmä ra fundación de santo tomás ajusco, archivo general de la nación, méxico, ramo de tierras vol. 2676, expediente. 4, archivo histórico de la biblioteca nacional de antropología, colección antigua, vol. 254, fojas 259 r.- 260 v."
"ra makja mra tjuju ra toribio benavente, motolinia,"	"ra makja mra thuju ra toribio benavente, motolinia,"
"tlauhquechol: ra ts'ints'u̱ xa ntjeni pode ge'a ra flamenco o ra guacamaya, pode ge gatjo ra tje̱nga ts'ints'u̱ ne dänga."	"tlauhquechol: ra ts'ints'u̱ xa ntjeni pode ge'a ra flamenco o ra guacamaya, pode ge gatjo ra che̱nga ts'ints'u̱ ne dänga."
"xkri tso̱ngä ngostji, kja jejni ya 'ñu; nä'ä rí ma nxamädo, ja nä'ä rí ma mäbo̱za. antes de"	"xkri tso̱ngä ngosthi, kja hejni ya 'ñu; nä'ä rí ma nxamädo, ha nä'ä rí ma mäbo̱za. antes de"
"ya b'e̱go ne ya b'e̱tri di ge'a nu'a ra dänga ndä ra ndada ra tjuju ra esteban de guzmán ra nzaya di gekua m'onda, ra ndada ra hernando pimentel, ra ndada ra antonio cortés, ra ndada xuua (juan) nuna ra mecoyoacan, ra ndada pedro motecuhzoma, me ma r'a ya kuänmi (firmas)."	"ya b'e̱ho ne ya b'e̱tri di ge'a nu'a ra dänga ndä ra ndada ra tjuju ra esteban de guzmán ra nzaya di gekua m'onda, ra ndada ra hernando pimentel, ra ndada ra antonio cortés, ra ndada xuua (juan) nuna ra mecoyoacan, ra ndada pedro motecuhzoma, me ma r'a ya kuänmi (firmas)."
"ya kuän' ajmä xa tjogi manteb'u̱e ge xa tjäst'i nu'a gatjo ra ntjandi to'o bi b'e̱di ge xa pu̱ngajñä nuna jmä getbu̱ n'ate ya jñäki ge ñä ya nso̱jo̱ jñäki ne xa y'oni nuna nt'ofo neje ja ra jñäki yazi xada kjä'i , ge'a nuna jñäki fadi ja ra jñämfo ko ra tjuju ra sistema braile."	"ya kuän' ajmä xa thogi manteb'u̱e ge xa thäst'i nu'a gatjo ra ntjandi to'o bi b'ehu̱ ge xa pungajñä nuna jmä getbu̱ n'ate ya jñäki ge ñä ya nso̱ho̱ jñäki ne xa y'oni nuna nt'ofo nehe ja ra jñäki yazi xada jä'i , ge'a nuna jñäki fadi ja ra jñämfo ko ra thuju ra sistema braile."
"ya r'atsanoya ra sahagán, ndoxkjua k'oi florentino, lib. xii, caps. xxix-xli (versión de ángel ma. garibay k.)."	"ya r'atsanoya ra sahagán, ndäxjua k'oi florentino, lib. xii, caps. xxix-xli (versión de ángel ma. garibay k.)."
despwés ya desde k'a ra momento ya k'a ya jíngi bénya'wi já té bimáju̱ k'a ra charroya'wi	despwés ya desde k'a ra momento ya k'a ya jingi béhña'wi ha té bimáhu̱ k'a ra charroya'wi
despwés ya xo bimu̱fí pe xo diario diario bu̱ nchúi mitsu̱ k'a ra charro mi'óbí k'a ra mikwála	despwés ya xo bimufí pe xo diario diario bu̱ nchúi mitsu̱ k'a ra charro mi'óbí k'a ra mikwála
goparejájé primero 'á k'a ra parte ánk'ú dínant'í	goparehajé primero 'á k'a ra parte áhnk'ú dínanthí
i asta fecha pues ignoro mucho pero másk'ŭ mäkjámá más ndímáignorajéwi	i asta fecha pues ignoro mucho pero másk'ŭ mäkhámá más ndímáignorahéwi
indu̱odiagí bastante	indu̱odiagí bastante
"inga se̱je̱ ra nntjandi ra manjyati ne ra portuguesa neje ra francesa, inglesa, alemana e italiana,"	"inga se̱he̱ ra nntjandi ra manjyati ne ra portuguesa nehe ra francesa, inglesa, alemana e italiana,"
k'a mädämé para ke mantenigíjé dígotjó mäbäjtsí pues ni modo dísufréjé	k'a mädämé para ke mantenihé díhthó mäbäjtsí pues ni modo dísuhé
kómá'u̱té ya fuente níjí	kómá'u̱te ya fuente níhi
"ne bi unbabi nduntji ya baba, bi enbabi ge mi ne da ñäui ra ndä (emperador) mi b'u̱i nuni manjyati, ne da jäni ra dänga ts'ofo ra evangelio,"	"ne bi unbabi nduntji ya baba, bi enbabi ge mi ne da ñäui ra ndä (emperador) mi b'u̱i nuni manjyati, ne da jäni ra dänga ts'oho ra evangelio,"
normalmente gójo	normalmente góho
panteón ga dó	panteón ga dó
pero de sesenta pantsítjá pa gotjók'ŭ kompletamente xatjó ndímáfădijé	pero de sesenta pantsítjá pa gothók'ŭ kompletamente xathó ndímáfadijé
pero eso sí binújgí mängŭjé kada ná	pero eso sí binúhígí mängŭjé kada ná
"po nuya kja'i to'o mi pede ge fädi ko ra tjuju ya ""cronistas de las indias”"	"po nuya kjä'i to'o mi pede ge fädi ko ra tjuju ya ""cronistas de las indias”"
pues este kábádá balewa este mínimo siento sinkwenta	pues este kábádá balewa este mínimo siento sinkuenta
pues nimodo bisufré k'a más ante mäabwelitajé komo mbu̱i enkajoso ra ntsoya	pues nimodo bisufré k'a más ante mäabwelitajé komo mbu̱i enkajoso ra nhtsoya
"ra nku̱t'i ra juajni ne ya ñ'udi ntjutsi ra agustin yáñez 2da. edición. biblioteca del estudiante universitario, unam, 1950."	"ra nku̱t'i ra juahni ne ya ñ'udi ntjutsi ra agustin yáñez 2da. edición. biblioteca del estudiante universitario, unam, 1950."
solamente ya riko alkansabi	solamente ya riko alhkanabi
xi ra tí na ta komedór 'á itsí na ta alimento k'a ra ndăni	xi ra tí na ta komedór 'á itsí na ta alimento k'a ra ndani
xo mitajá ra ntsoya mitá sínko pesos ra béjña dos sinkwenta	xo mitahá ra ntsoha mitá sínko pesos ra béhña dos sinkwenta
xo takja mä sesenta wik'a takja mä sesenta bitajkíjéya'wik'a	xo takja mä sesenta wik'a takja mä sesenta bitahkjíjéya'wik'a
á panteón ga dó níjí	á panteón ga dó níhi
ñúdigejña dabadijíya' razo''ya' mientra más dandu̱jté	ñúdigejña dabadihíya' razo''ya' mientra más dandu̱hté
"-nu'u̱ dige'u̱ b'u̱i nuni maxey (tolimán ne amealco), dige'u̱ temoaya nuni ra ra jyodi estado de méxico ne mar'a ya jyodi nuni puebla ne veracruz"	"-nu'u̱ dige'u̱ b'u̱i nuni maxey (tolimán ne amealco), dige'u̱ temoaya nuni ra ra jyodi estado de méxico ne mar'a ya jyodi nuni puebla ne veracruz"
"ne mätajekitjo di kja getbu̱, ra jñäpi ra joel martinez hernández ne ra jotjo tjuajmä ra natalio hernández xocoyotzin, nuya yojo ya xajnate ri ñ'eje ya y'u̱ dige'u̱ ya ndeznä."	"ne mätajekitho di kja getbu̱, ra jñäpi ra joel martinez hernández ne ra hotjo thuajmä ra natalio hernández xocoyotzin, nuya yojo ya xajnate ri ñ'ehje ya y'u̱ dige'u̱ ya ndeznä."
"-n'ate pa n'a ra zänä de ra r'e̱t'a ma jñäto ""zänä"" mi zo̱ta ya munts'i ya n'ate ya pa ge mi joki ra xihuitl o ""ra m'ede ra kje̱ya"""	"
- n'ate pa n'a ra zänä de ra r'e̱t'a ma jñäto ""zänä"" mi zo̱ta ya munts'i ya n'ate ya pa ge mi joki ra xihuitl o ""ra m'ede ra che̱ya"""
bi ma di gepu̱ jam''u̱ ra ngo pa da ts'itje ya it'adeje (Tlahuano) ba po̱ni nubu̱ tlapechhuan. mra ngo ra izcalli.	bi ma di gepu̱ jam''u̱ ra ngo pa da ts'itje ya it'adehe (Tlahuano) ba po̱ni nubu̱ tlapechhuan. mra ngo ra izcalli.
bi mu̱di da jyoka ya t'u̱kats'u̱fabo̱kja. ge'a ra ntujni bi nkja nuni Coyohuehuetzin ne ma gojo ba nkja.	bi mu̱di da johka ya t'u̱kats'u̱fabo̱kja. ge'a ra ntuhni bi nka nuni Coyohuehuetzin ne ma gojo ba nka.
"bri tjo ra cuauhnochtli, ra gabida tlacatecco, ra cuapan, ra gabida huitznáhuac, ra makja Amantlan, ne ra makja tlacopan."	"bri tjo ra cuauhnochtli, ra gabida tlacatecco, ra cuapan, ra gabida huitznáhuac, ra makja Amantlan, ne ra makja tlacopan."
bri ts'u̱tuabi ja ra y'u̱ga n'a ra nto̱de dega t'u̱ka joga do dega chalchihuite: made mi juts'i n'a ra tsant'i dega k'astabokja.	ha ts'u̱tuabi ha ra y'u̱ga n'a ra nto̱de dega t'u̱ka joga do dega chalchihuite: made mi juts'i n'a ra tsant'i dega k'astaboja.
"Castañeda, ra t'u ra Aquiyahualcatecuhtli, m ra ndä nuni tlaxcala."	"Castañeda, ra t'u ra Aquiyahualcatecuhtli, m ra ndä nuni tlaxcala."
Coaíhuitl mra gabida ndeznä nuya mapa digeá ra t'o̱t'ats' okamfeni.	Coaíhuitl mra gabida ndeznä nuya mapa digeá ra t'o̱h'o̱ts' okamfeni.
di gepu̱ ba koi pa nuni ra Xochimilco. nubu̱ ba tu ya kjä'i ya metlatelolco	di gepu̱ ba koi pa nuni ra Xochimilco. nubu̱ ba tu ya jä'i ya metlatelolco
"ebu̱ ba eje man'aki ba te̱nga ra t'o̱jo̱ ra tjuju ra Citlaltépec. Tlacopan, nubia ba o̱t'ra b'u̱i ja ra ndo̱m'ijmu."	"ebu̱ ba ehe man'aki ba te̱nga ra t'o̱ho̱ ra thuju ra Citlaltépec. Tlacopan, nubia ba o̱t'ra b'u̱i ha ra ndo̱m'ihmu."
ebu̱ bi dädi ra Cihuacóatl:	ebu̱ bi dädi ra Cihuacóatl:
ebu̱ bi ñä ra Cuauhtémoc bi xipabi ra Cihuacóatl:	ebu̱ bi ñä ra Cuauhtémoc bi sipabi ra Cihuacóatl:
"gojo n'ate ya pa ne ebu̱ bi yopa bo̱ni pa di mani ra Huaxtepec, ra Cuauhnahuac (Cuernavaca)."	"goho n'ate ya pa ne ebu̱ bi yopa bo̱ni pa di mani ra Huaxtepec, ra Cuauhnahuac (Cuernavaca)."
"gue dá nhuat'i mbo kja ra ximjai,"	"gue dá nhuathi mbo kja ra ximhai,"
"i nte ra nge'a, ya jmä juts'i ja ra ndäxkjua k'oi ra códice ra ramírez uni nuna b'e̱de mä makjuäni ngu mä ra ntje̱ka b'ede ne ra ndädi nu'a ra nänä mra tjuju ra yacotzin, ra nänä ra ixtlilxóchitl,"	"i nte ra nge'a, ya hmä juts'i ha ra ndäxjua k'oi ra códice ra ramírez uni nuna b'ehde mä makjuäni ngu mä ra ntjehka b'ede ne ra ndädi nu'a ra nänä mra tjuju ra yacotzin, ra nänä ra ixtlilxóchitl,"
"inda jyo ko ra ndäxjua ixtlilxóchtil, ra dada ra Nezahualcóyotl ni ko ra fernando de alva ixtlilxóchitl."	"inda hyo ko ra ndäxjua ixtlilxóchtil, ra dada ra Nezahualcóyotl ni ko ra fernando de alva ixtlilxóchitl."
"k o ya bu̱' bai, ko ya makahuai,"	"ko ya bu̱' bai, ko ya makahuai,"
"mi fudi da t'axka ra xudi ba ts'i, bri tját'a ja n'a ra za mi b'ai ja ra ngu ra Ahuizotzin nuni ra Acatliyacapan."	"mi fudi da t'axka ra xudi ba ts'i, bri thát'a ha n'a ra za mi b'ai ha ra ngu ra Ahuizotzin nuni ra Acatliyacapan."
mi gu̱t'a ra ñ'u̱ n'a ra makja ge'a mra b'e̱fi mi zu nu'a ra mäka jai mra tjuju ra Yohualichan.	mi gu̱t'a ra ñ'u̱ n'a ra makja ge'a mra b'e̱hi mi zu nu'a ra mäka jai mra tjuju ra Yohualichan.
"mi y'o y'oua, mi tuts'i ya bu̱'bai dega za, ne r'a mi jä dega bo̱ja ne ya mahuai."	"mi y'o y'oua, mi tuts'i ya bu̱'bai dega za, ne r'a mi jä dega boja ne ya mahuai."
mra ngu ra Aztautzin ge'a mi kja getbu̱ nuni ra Amáxac.	mra ngu ra Aztautzin he'a mi ja getbu̱ nuni ra Amáxac
n'a ra jyo ne man'a bi xokuabi ra debi. ra Cuauhtemoctzin bri xokuabi ra debi ge'a se̱je̱.	n'a ra hyo ne man'a bi xokuabi ra debi. ra Cuauhtemoctzin bri xokuabi ra debi ge'a he̱je̱.
"ne m'e̱fa bi ma xki jäki ya je dega magabi, ñätsi bi ntsaya ra mahuai ne ra bu̱'bai, bri nkjonda ya bo̱najmu nuni Acachinanco."	"ne me̱fa bi ma xki jäki ya he dega magabi, ñätsi bi ntsaya ra mahuai ne ra bu̱'bai, bri nkjonda ya bonahmu nuni Acachinanco."
"ne nkjabu̱ bri t'ot'e neje ko mar'a ya bo̱najmu mi pe̱tsi ra t'u̱ka tsu̱tui ja ya t'u̱ka jnini, nuyu̱ to'o mi b'e̱pi da t'o̱t'e ngu nuni Xalapan, Tlaxcalan, Tehuantepec, Oaxaca neje mar'a ya bo̱najmu mar'a ya t'u̱ka jnini jabu̱ bi guat'i ya nduste, ya dumantjuju dega k'astaboja, ge ya tjuju ya kristiano [...]"	"ne nkjabu̱ bri t'ot'e nehe ko mar'a ya bonahmu mi pe̱tsi ra t'u̱ka tsu̱tui ha ya t'u̱ka hnini, nuyu̱ to'o mi b'e̱pi da t'o̱t'e ngu nuni Xalapan, Tlaxcalan, Tehuantepec, Oaxaca nehe mar'a ya bonahmu mar'a ya t'u̱ka hnini jabu̱ bi guat'i ya nduste, ya dumantjuju dega k'astaboja, ge ya tjuju ya kristiano [...]"
"ne nu'a ri däme, pu̱ ñ'a'i, nugi ga ma ga tsogi'i nuni Cuetlachcoapan [n'a ra jnini nuni puebla],"	"ne nu'a ri däme, pu̱ ñ'a'i, nugi ga ma ga thogi'i nuni Cuetlachcoapan [n'a ra hnini nuni puebla],"
"ne nu'u̱ bi mani dra ts'okat'o̱t'amfeni nuni Michoacán, Xalisco, Culhuacan ne nuni neje Pánuco, ne nuni Oaxaca, Tehuantepec ne Guatemala, ne nuua ra r'ayo majyati, nub'u̱ bri t'o̱t'a ra mabagi pa dra uadi dra t'o̱t'a nu'a ra ts'okat'o̱t'amfeni inda tsogije se̱je̱."	"ne nu'a bi mani dra ts'okato̱t'amfeni nuni Michoacán, Xalisco, Culhuacan ne nuni nehe Pánuco, ne nuni Oaxaca, Tehuantepec ne Guatemala, ne nu'a ra r'ayo majyati, nub'u̱ bri t'o̱t'a ra mabagi pa dra uadi dra t'o̱t'a nu'a ra ts'okato̱t'amfeni inda tsoghije se̱he̱."
"nejege'a ra ngätsi. mi jä ya mpe̱fi dega mabagi,ya nkjom'a te ne ya fu̱nbo̱kja, inte ma mahuai mi jä ni ge'a ya bu'bai."	"nehege'a ra ngätsi. mi jä ya mpe̱fi dega mabagi,ya nkjom'a te ne ya fu̱nbo̱hja, inte ma mahuai mi jä ni ge'a ya bu'bai."
njabu̱ bi bo̱nga dega xui. mra ngo nub'u̱ ra Tecuílhuitl bi bo̱nga: nub'u̱ bi kja ya du ja ra r'ani ra deje ya u̱erna.	njabu̱ bi bo̱nga dega xui. mra ngo nub'u̱ ra Tecuílhuitl bi bo̱nga: nub'u̱ bi ja ya du ha ra r'ani ra dehe ya u̱erna.
"nub'u̱ bi tjandi ra Tzihuacpopoca, bi t'ena:"	"nub'u̱ bi handi ra Tzihuacpopoca, bi t'ena:"
"nub'u̱ ya ñämfo̱ bi jandi ge xa ñ'eje nubu̱ da tsu̱di, ge mi tekuabi ra nest'iji, m'estjo bi munts'i bi miji ya mahuai."	"nub'u̱ ya ñämfo̱ bi handi ge xa ñ'eje nub'u̱ da tsu̱di, ge mi tekuabi ra nest'iji, m'estjo bi munts'i bi miji ya mahuai."
"nuna kjä'i inbi tsa bi tjädi makjuäni nu'a ra nt'ani. ingra nge'a nuya pa bi jneki n'a ra jyoya jä'i ra macehual (hombre de pueblo),"	"nuna jä'i inbi tsa bi djädi makjuäni nu'a ra nt'ani. ingra nge'a nuya pa bi jneki n'a ra jyoya jä'i ra macehual (hombre de pueblo),"
"nuna nte̱nga b'ede ja bri jat'i ra Tzihuacpopocatzin, bi o̱t'e da tjogi ge'a ra ts'e̱y'e̱jmu. inbi bo̱nga nuna nt'o̱t'e bi tsu̱diju̱ ko ma r'a ya b'e̱jni. ma ra ya ñ'ete inbi jopi da kju̱ man'aki ra ñ'u nuya ts'okate. pe nuya inbi joki ra b'ai."	"nuna nte̱nga b'ede ha bri jat'i ra Tzihuacpopocatzin, bi o̱t'ehu da thogi ge'a ra ts'e̱y'e̱jmu. inbi bo̱nga nuna nt'o̱t'e bi tsu̱diju̱ ko ma r'a ya b'e̱hni. ha ra ya ñ'ete inbi jopi da ju̱ man'aki ra ñ'u nuya ts'okate. pe nuya inbi joki ra b'ai."
"nuua di udije ra jñäpi bi nto̱t'e bi nkja ra agosto ra kje̱ya 1595, n'a ra kjä'i mra tjuju ra miguel Hernández, ra me Chiyauhtzinco,"	"nuua di udije ra hnäpi bi nto̱t'e bi nkja ra agosto ra jeyea 1595, n'a ra jä'i mra tjuju ra miguel Hernández, ra me Chiyauhtzinco,"
nuya bo̱najmu ya mem'onda ñätsi bi ñäui ra Cihuacóatl Tlacotzin m'estjo bi tjädi:	nuya bonahmu ya mem'onda ñätsi bi ñäui ra Cihuacóatl Tlacotzin m'estjo bi jädi:
ra Tlacatécatl mra me Cuauhtitlan ne ra bktri ra mbot'a ngu bri kjapi ya tsat'yo bi zi.	ra Tlacatécatl mra me Cuauhtitlan ne ra pktri ra mbot'a ngu bri japi ya tsat'yo bi zi.
ra doy'e̱ pajni xki njom'i ko ya chalchihuite.	ra doy'e̱ pahni xki njom'i ko ya chalchihuite.
"ra mu̱di ra Cuauhtémoc, ra jmu ra bondo, ra nyojo ra tlatsotzin, ra Cihuacóatl ra njñu ra oquiztzin, ra bo̱najmu ja ra nini ra aztsapotzaltso Mexicapan, ra ngojo ra panitzin, ra bo̱najmu nuni ra Ecatepec,"	"ra mu̱di ra Cuauhtémoc, ra jmu ra bono, ra nyojo ra tlatsotzin, ra Cihuacóatl ra ñu ra oquiztzin, ra bonahmu ha ra nini ra aztsapotzaltso Mexicapan, ra ngojo ra panitzin, ra bonahmu nuni ra Ecatepec,"
"ra mu̱di ra pa mi o̱t'e ra ngo ra mäkime ra u, ra tjuju ra Huixtocihuatl"	"ra mu̱di ra pa mi o̱t'ehu ra ngo ra mäkime ra u, ra thuhu ra Huixtocihuatl"
ra nge'a bi mu̱ni ko ra mahuai ja ra xu̱tja nu'a to'o bi umbabi ra kji.	ra nge'a bi mu̱ni ko ra mahuai ha ra xu̱tja nu'a to'o bi umbabi ra kji.
"ra nyojo, bi tjo ra ndä ra Nauhtla, mra tjuju ra Cohualpopocatzin."	"ra nyojo, bi thjo ra ndä ra Nauhtla, mra thuju ra Cohualpopocatzin."
"unga ya ngue̱nda te ra ts'omu̱i mi bu̱'i ne mi kjapi da ntso̱m'i nuya macehualtin, nkjabu̱ mi tjutuabi ya kjä'i mi b'u̱i te ma za"	"unga ya ngue̱nda te ra ts'omu̱i mi bu̱'i ne mi kjapi da ntso̱m'i nuya macehualtin, nkjabu̱ mi thutuabi ya jä'i mi b'u̱i te ma za"
"xib'u̱ bri fádi ge nuya je mi kja nuni ra Cuauhchichilco, ja Xaltocan; ge mi pttsi ya ndá."	"xib'u̱ bri fádi ge nuya he mi kja nuni ra Cuauhchichilco, ha Xaltocan; ge mi pttsi ya ndá."
"xki mbo̱ni nubu̱ ra jyodi ra Cuehuecatitlan,"	"xki mbo̱ni nubu̱ ra hyodi ra Cuehuecatitlan,"
"xki tjete ra ixtlilxóchitl ne ra ku ra Cohuanacotzin ko ya je dega dänga ndä bi mu̱di da jäni ra joga ts'ofo ya evangelio,"	"xki tete ra ixtlilxóchitl ne ra ku ra Cohuanacotzin ko ya he dega dänga ndä bi mu̱di da jäni ra joga ts'ofo ya evangelio,"
"ya dänga ñu̱ni nsafi, ya nsafi, ya mahuai, jangu nu'u̱ gatjo xki tagi mbo ja ra jñe."	"ya dänga ñu̱ni nsafi, ya nsafi, ya mahuai, hangu nu'u̱ gatho xki tagi mbo ha ra jñe."
"bi o̱tuabi nu'a ra makja xki nk'ojni mra tjuju ra alonso ruiz, ge mi y'o nuni juamuxtitan (Huamuxtitlan) nuni ra jyodi guerrero."	"bi o̱thuabi nu'a ra makja xki nk'ohni mra tjuju ra alonso ruiz, ge mi y'o nuni juamuxtitan (Huamuxtitlan) nuni ra jyodi guerrero."
"di pädi xajño nuna b'e̱fi neje yojo to'o di pädi da mpe̱fi da y'este nuya joga do majye̱gi ya xito, mra tjuju ra ambetz'ihuay."	"di pädi xajño nuna b'ehi nehe yojo to'o di pädi da mpe̱fi da y'este nuya joga do majye̱gi ya xito, mra tjuju ra ambetz'ihuay."
"dra tjoki ra nto̱de, ra ketzal dra b'e̱ nuni Coyohuacan."	"dra joki ra nto̱de, ra ketzal dra b'e̱h nuni Coyohuacan."
e mi r'ani dega xui ra Cihuacóatl g'ea mi zoni ne mı mafi.	e mi r'ani dega xui ra Cihuacóatl gea mi zoni ne mı mafi.
"ebu̱ bi gäi jabu̱ mi to̱ge ebu̱ bi yopa ma ja ra jnini ra Cuetaxtlan,"	"ebu̱ bi gäi jabu̱ mi to̱ge ebu̱ bi yopa ma ha ra hnini ra Cuetaxtlan,"
"ge'a ra mu̱di ra tjuju ra Hernando, ra nge'a nkjabu̱ mra tjuju ra takjä ra Cortés neje nkjabu̱ mra tjuju ra ndä Católico ne ra ku ra Cohuanacotzin bi tjutuabi ra Pedro po ra Pedro Alvarado ra nge'a ra takjä,"	"ge'a ra mu̱di ra tjuju ra Hernando, ra nge'a nkjabu̱ mra tjuju ra takjä ra Cortés nehe nkjabu̱ mra tjuju ra ndä Católico ne ra ku ra Cohuanacotzin bi thutuabi ra Pedro po ra Pedro Alvarado ra nge'a ra takjä,"
"ma n'a mi b'ai nuni teotletso, jabu̱ ra ñ'u̱ pa manjuäntjo pa da zo̱ni nuni ra peñón (Tepetzinco)."	"ma n'a mi b'ai nuni teotletso, jabu̱ ra ñ'u̱ pa manjuänto pa da zo̱ni nuni ra peñón (Tepetzinco)"
"mi tso̱jo̱ getbu̱ ra fu̱nga t'o̱jo̱, jabu̱ mi tjutuabi ""takjón ra nxu̱ni, nkjabu̱ bi jutuabi ya ndeznä ya b'e̱jnanoya bi pe̱jni ra ts'e̱y'e̱jmu, mi gu̱t'a ra ñ'u ra Tzihuacpopocatzin, bi bo̱nga ja ra ñ'u."	"mi tso̱ho̱ getbu̱ ra fu̱nga t'o̱ho̱, habu̱ mi tjutuabi ""takjón ra nxu̱ni, nkjabu̱ bi jutuabi ya ndeznä ya b'e̱hnanoya bi pe̱jni ra ts'e̱y'e̱jmu, mi gu̱t'a ra ñ'u ra Tzihuacpopocatzin, bi bo̱nga ha ra ñ'u."
mra ku ra Cacamatzin mra bo̱najmu nuni Tetzcoco mri ñ'oui va kjä'i mi y'o mpaja.	mä ra Cacamatzin mä bonahmu nuni Tetzcoco mä ñ'oui va jä'i mi y'o mpaja.
"n'a ra nto̱de dega chalchihuite, xi m'et'e dega ze̱ka do, neje mi pe̱tsi n'a ra tsant'i de ga k'astabokja."	"n'a ra nto̱de dega chalchihuite, xi m'et'e dega ze̱ka do, nehe mi pe̱tsi n'a ra tsant'i de ga k'astaboja."
ne nduntji ya ambetz'ihuay ne mar'a joga do mi pe̱tsi ra mu'ui:	ne nduntji ya ambetz'ihuay ne mar'a joga do mi pe̱tsi ra mu'ui:
neje n'a ya tje̱stji dega mboťahuaido.	nehe n'a ya tje̱stji dega mboťahuaido.
"nuna bi o̱t'a ra ntso̱m'i ra nge'a neje nuya ya b'e̱datsi bi tsini ko ra Cortés ne ra Cohuanacotzin ne ra ixtlilxóchitl xki nsofo pa ra ixtlilxóchitl da gu̱ka ya kjä'i ge mi zu ya jyodi, nkjabu̱ mi pe̱jna akjuä da t'o̱t'e."	"nuna bi o̱t'a ra ntso̱m'i ra nge'a nehe nuya ya b'e̱datsi bi tsini ko ra Cortés ne ra Cohuanacotzin ne ra ixtlilxóchitl xki nsofo pa ra ixtlilxóchitl da gu̱ka ya jä'i ge mi zu ya jyodi, nkjabu̱ mi pe̱jna akjuä da t'o̱t'e"
"nuna nt'o̱t'e bi ntjandi xa nts'ogi njabu̱ bri tjutuabi, bi ena ge mra nzu̱te ko ma m'u̱jai ra nzu̱te ne mi tjutsuabi ko ya mpe̱bi dega mabagì, jabu̱ jmä ge n'a di ge'u̱ bi y'e̱nga n'a ra do, ko nge'a bi jyo, nu'u̱ mar'a ya b'e̱go ge mä ge nu'u̱ se̱je̱ ya ñämfo̱ bi jyo bi mu̱tu'a n'a ra mahuai ja ri ngati bi mu̱tuabi n'a ra nzu̱ni."	"nuna nt'o̱he bi ntjandi xa nts'ogi njabu̱ bri thutuabi, bi ena ge mra nzu̱the ko ma m'u̱hai ra nzu̱the ne mi thutsuabi ko ya mpe̱hi dega mabagì, jabu̱ jmä ge n'a di ge'u̱ bi y'e̱nga n'a ra do, ko nge'a bi jyo, nu'u̱ mar'a ya b'e̱ho ge mä ge nu'u̱ se̱he̱ ya ñämfo̱ bi jyo bi mu̱thu'a n'a ra mahuai ha ri ngati bi mu̱thuabi n'a ra nzu̱ni."
"ra Cuauhtémoc, Tlacotzin, ra Cihuacóatl, Oquiztzin, Panitzin, Motelhuihtzin; nuna bi sofo ra tsortés nuni Coyoacan, nu'u̱ to'o mi pädi yojo ya jñäki ngu'a ra jerónimo aguilar ra malintzin."	"ra Cuauhtémoc, Tlacotzin, ra Cihuacóatl, Oquiztzin, Panitzin, Motelhuihtzin; nuna bi sofo ra tsortés nuni Coyoacan, nu'u̱ to'o mi pädi yojo ya hñäki ngu'a ra jerónimo aguilar ra malintzin."
t'ena ge ya macehual [ya kjä'i b'u̱i ja ra jyoya]	t'ena ge ya macehual [ya jä'i b'u̱i ha ra jyoya]
"xki tjokuabi nuya jotjo ts'ints'u̱ mra tjuju ra ""tlauhquecho"" ne “tzinitzcan zacuan"","	"xki jokuabi nuya hotjo ts'ints'u̱ mra thuhu ra ""tlauhquecho"" ne “tzinitzcan zacuan”,"
-¿te be'a gi mä nu'i Cihuacóatl?	¿te be'a gi mä nu'i Cihuacóatl?
"bi k'ajni ko ya dänga ñuni nzafi ne bi tjetse ko ya makahuai nuya otomi geb'u̱ bi japi bi b'e̱di, bi mä nuyu̱:"	"bi kajni ko ya dang'a nuni nzafi ne bi tetse ko ya makahuai nuya otomi geb'u̱ bi japi bi b'edi, bi mä nuyu̱"
da tjuts'i ya nkjot'ijñä ( )	da thuts'i ya nkjot'ihñä
"da umbabije te da zi, da kjapabije nduntji ma zu."	"da umbabije te da zi, da japabije nduntji ma zu."
ebu̱ bi mä nuna b'e̱fi xa tjoki xajño bi kjohya ra ts'e̱y'e̱jmu.	ebu̱ bi mä nuna b'efi xa thoki xajño bi johya ra ts'e̱y'e̱jmu.
"fernando alva ixtlilxóchitl, xiii nkjändajmä ""ra ñ'eje ya ñämfo̱ ne ra mu̱di ra joga ts'ofo ra evangelio."""	"fernando alva ixtlilxóchitl, xiii nkjändajmä ""ra ñ'ehje ya ñämfo̱ ne ra mu̱di ra joga ts'ofo ra evangelio."""
"ga kjuatiju̱ nu'a juts'i nkjani, ya ts'ojä'i, ra carranza, ge xa o̱t'a ya ts'okuate pa gekagiju̱; ga o̱t'e da nkja ra ts'e̱di ma munts' ne njabu̱ ga tsu̱diju̱ da nkja nu'a ra joga tsu̱tui, da nkja ra jai, ra jñegi ne ra joga ts'u̱tui;"	"ga juatihu̱ nu'a juts'i nkjani, ya ts'ohä'i, ra carranza, ge xa o̱t'a ya ts'ohuate pa gekagiju̱; ga o̱t'ehu̱ da nkja ra ts'e̱di ma munts' ne njabu̱ ga tsu̱diju̱ da nkja nu'a ra joga tsu̱tui, da nkja ra jai, ra jñegi ne ra joga ts'u̱tui;"
gatjo ya jyoyakjä'i mi b'u̱i ja ra jnini bi jandi.	gatho ya johyakjä'i mi b'u̱i ha ra hnini bi handi.
"ja bi jäni ra ñ'udi, ma kjä'iju̱ bi ent'i gatjo majye̱gi nuya nzu̱te"	"ha bi jäni ra ñ'udi, ma jä'ihu̱ bi ent'i gatjo majye̱gi nuya nzu̱te"
"ja n'aa nza̱tjo xudi ra pale berto, bi bo̱ni nda jyonga te nda nzimxidi ngetjo nda zi ya jme jyaxtjo mi u̱xa ya u, ua ngu mi nzäi mi nkajui yá jme nuya chukju̱ xa jogi ja nuya 'bomuja̱i nts'ät'i, nt'o̱kuä;"	"ha n'aa nzä́tjo xudi ra pale berto, bi bo̱ni nda jyonga te nda nzimxidi ngetjo nda zi ya hme jyaxtjo mi u̱xa ya u, ua ngu mi nzäi mi nkajui yá hme nuya chukju̱ xa jogi ha nuya 'bomuja̱i nts'ät'i, nt'o̱kuä;"
"ja nubia di ndäki, di ndändiñäjmu, di ma ga ts'u̱tsa'i ri y'e, ga ndäne'i ra nge'a nu'a'i ma makjaje, ra bartolomé lópez, nub'u̱ mi nkjuäni ma b'e̱jña inbi nkjuäni ja nubu̱ mi xaxi pa da o̱t'a ya tso̱mfen"	"ha nubia di ndäki, di ndändiñäjmu, di ma ga ts'u̱tsa'i ri y'e, ga ndäne'i ra nge'a nu'a'i ma makjaje, ra bartolomé lópez, nub'u̱ mi nkjuäni ma b'e̱hña inbi nkjuäni ha nubu̱ mi xaxi pa da o̱t'a ya tso̱mfen"
"ja ya t'u̱ka ze̱ki tjuts'i n'a tu̱kitjo nuna tjogi ge bi juxa ra fernando alva ixtlilxóchitl, nu'a b'e̱tsi ra xiiii nkjondajmä."	"ha ya t'u̱ka ze̱ki tsuts'i n'a tu̱kitjo nuna thogi ge bi juxa ra fernando alva ixtlilxóchitl, nu'a b'e̱tsi ra xiiii nkjondajmä"
jabu̱ ga kju̱he nuyu̱ (ya tenochcas) te gi joniju̱?	jabu̱ ga ju̱he nuyu̱ (ya tenochcas) te gi jonihu̱?
"jam'u̱ gatjo ya kjuän'ajmä ge nuua xa ze̱ti ri ñ'eje dige'a ya noya ya mu̱dimejai ja ra jñä ya ndeznä, nuna tjuju ri uni inga se̱je̱ ra n'atsanoya pa da fädi ra jñämfo̱, ingi ri me̱udi dige'a ra jmä fu̱oti dige'a nuna ra jñäki ra netzajualtsoyotl. ne ra cuauhtémoc."	"jam'u̱ gatho ya juän'ajmä ge nuha xa ze̱ti ri ñ'ehje dige'a ya noya ya mudimejai ha ra jñä ya ndeznä, nuna tjuju ri uni inga se̱he̱ ra n'atsanoya pa da fädi ra jñämfo̱, ingi ri me̱udi dige'a ra jmä fu̱oti dige'a nuna ra jñäki ra netzajualtsoyotl. ne ra cuauhtémoc."
mi jneki ngu ma kjä'iju̱ ngabu̱ mri jneki.	mi jneki ngu ma jä'ihu̱ ngabu̱ mri jneki.
"nduntji bri kjojya, bri tjuxpabi gatjo nu'a mi o̱t'abi ra b'edi, ko nge'u̱ bi m'u̱i ne mi t'umbabi ya t'ixu:"	"nduntji bri johya, bri thuxpabi gatho nu'a mi o̱thabi ra b'edi, ko nge'u̱ bi m'ui ne mi thumbabi ya thixu:"
"ngu mra me̱ti, nu'a r'a hyodi, jabu mi y'o, n'a ngu n'a mi kjohya mi mfe̱m'a xinxi xi mi kjohya ya ndäte, mi tjede n'a ngu n'a mi jñu̱fi ne mi fe̱m'a ya xinxi: xi mi b'u̱i mpaja."	"ngu mra me̱ti, nu'a r'a hyodi, jabu mi y'o, n'a ngu n'a mi johya mi mfe̱m'a xinxi xi mi johya ya ndäte, mi tjede n'a ngu n'a mi ñu̱fi ne mi fe̱m'a ya xinxi: xi mi b'u̱i mpaja."
"nkjabu̱ ri ñ'eje ya kje̱ya inda m'e̱di, inda mpumfri, ga nzäi ga pe̱tsi nugagiju̱ ja ma mfeniju̱, ga pe̱tsi nugagiju̱, ra bätsi dige'u̱, ya b'e̱to, ya ntsaniku, ya mbänga b'e̱to ne to'o dra ñ'epu̱, to'o majye̱gigiju̱, ma kjiju̱, ya ku̱ju̱."	"nkjabu̱ ri ñ'ehje ya kje̱ya inda m'e̱di, inda mpumfri, ga nzäi ga pe̱tsi nugagihju̱ ha ma mfenihju̱, ga pe̱tsi nugagihju̱, ra bätsi dige'u̱, ya b'e̱to, ya ntsaniku, ya mbänga b'e̱to ne to'o dra ñ'epu̱, to'o majyegigihju̱, ma kjihju̱, ya ku̱hju̱."
"nu xä otj'u̱, ma gä ñ'kjäju̱"	"nu xä otj'u̱, ma gä ñ'kjähu̱"
"nuga̱ xi di ne'i, jindi pädi jankja..."	"nuga̱ xi di ne'i, hindi pädi hankja..."
"num'u̱ di kjojyaju̱, nkueju̱, nts'o̱miju̱, tsuju ne pa da t'o̱xkäju̱ di jojñu̱ nu ya nt'u̱i xi di 'yooju̱ (¡!). nuya da nt'ot'i ko ra dänt'ot'í"	"num'u̱ di johyaju̱, nkueju̱, nts'ohmu̱ju̱, tsuju ne pa da t'ohkäju̱ di johñu̱ nu ya nt'ui xi di 'yooju̱ (¡!). nuya da nt'ot'i ko ra dänt'ot'í"
"nuna bi kjojya ja ra mabagi,"	"nuna bi johya ha ra mabagi,"
"nuya jñu o gojoya pa bi b'u̱i nubu̱ bi xitsuabi ra kjäpadeje nduntji ya kjä'i, ngu xa t'ena."	"nuya jñu o gojoya pa bi b'u̱i nubu̱ bi xitsuhabi ra jähpadehe nduntji ya jä'i, ngu xa t'ena."
"nuya tsat'io mi b'et'o, mi gu̱t'a ra ñ'u, mi teni, ya xiñu mi kju̱ts'i pa mañä, xi mi päjä gatjo mi jandi mi nest'iji: mi tu̱ta ya kjijni"	"nuya tsat'io mi b'et'o, mi gu̱t'a ra ñ'u, mi teni, ya xiñu mi juts'i pa mañä, xi mi päjä gatjo mi handi mi nest'iji: mi tu̱ta ya hijni"
"pe, nu'i ndada nu'i ma t'ek'ei ra makja, nub'u̱ nu'i ingi zugagije, ¿jankja, nuua, ra jyo di ge'a, ga tsogi nubu̱ [nu'a ma b'e̱jña]?"	"pe, nu'i ndada nu'i ma t'ek'ei ra makja, nub'u̱ nu'i ingi zugagije, ¿jankja, nuua, ra jyo di ge'a, ga thogi nubu̱ [nu'a ma b'e̱hña]?"
"r'a ya kjä'i mi b'u̱i ja ra ngumi kja nunu ja ra jnini ri mankjuäntjo pa da tsoni nubu̱ ra amáxac,"	"r'a ya jä'i mi b'u̱i ha ra ngumi kja nunu ha ra hnini ri mankjuäntjo pa da tsoni nubu̱ ra amáxac,"
"ra nge'a di o̱t'a nuna noya ra ts'u̱tui ne gatjo to'o da guat'a ja ma jyoje, nu'u̱ to'o da ne, da me̱tsi n'a ra joga m'u̱i ne da m'u̱i mankjuäntjä. ja nubu̱ xa mabu̱ ma noya ge di pe̱tsi ra tsa, dega joga kjä'i ne dega jogat'o̱t'antujni"	"ra nge'a di o̱t'a nuna noya ra ts'u̱tui ne gatho to'o da guat'a ha ma jyoje, nu'u̱ to'o da ne, da me̱tsi n'a ra joga m'u̱i ne da m'u̱i mankjäntjä. ha nubu̱ xa mabu̱ ma noya ge di pe̱tsi ra tsa, dega joga jä'i ne dega jogat'o̱t'antho̱ni"
ra ngejna nuna pa bi ma n'a ra ñ'u mankjuäntjo.	ra hejna nuna pa bi ma n'a ra ñ'u mankjäntjo.
"ra njñu ne ra ngästsi ra b'ist'ofo di juts'iju̱ ja nuna ze̱ki b'ist'ofo, ri ñ'eje ra vii nkjondajmä ra chimalpain,"	"ra njñu ne ra ngäthi ra b'ist'oho di juts'iju̱ ha nuna ze̱ki b'ist'oho, ri ñ'ehe ra vii nkjondajmä ra chimalpain,"
"ra ntjädi ra cuitlahuacatzin bi ena ge ina da o̱t'e nuya bi b'e̱pabi ya nso̱jo̱kjä'i,"	"ra ntjädi ra cuitlahuacatzin bi ena ge ina da o̱t'ehu nuya bi b'e̱pabi ya nso̱hokjä'i,"
"ra nyojo nu'a mi zu ra tepoztlan; ra njñu ra me tizatlan, ra nkjojo mi ñ'eje nuni huehuetlan ne ra nku̱ta mra dänga mictlan."	"ra ñojo nu'a mi zu ra tepoztlan; ra ñu ra me tizatlan, ra njojo mi ñ'ehe nuni huehuetlan ne ra nku̱ta mra dänga mictlan."
ri ñ'udi xajño nubia jankja beni ya metlaxcala bi do̱m'i mpaja nuya nso̱jo̱ kjä'i.	ri ñ'udi xajño nubia hankja beni ya metlaxcala bi do̱m'i mpaja nuya nso̱ho̱ jä'i.
"t'ena ge inbi unga mfädi pa gatjo ya kjä'i mi ñ'oui, ge nuna ndada ra marqués da ñ'eje dra jmu ja ma jaije, da ja me̱ti nu'a di pe̱tsije neje dra kjakagije ga mpe̱fije ra jai ge bi umbabi o bi jänbabi ya joga jai ya n'añ'o jnini."	"t'ena ge inbi unga mfädi pa gatho ya jä'i mi ñ'oui, ge nuna ndada ra marqués da ñ'eje dra jmu ha ma jaije, da ha me̱ti nu'a di pe̱tsije nehe dra jakakagije ga mpe̱fije ra jai ge bi umbabi o bi jänbabi ya joga jai ya n'añ'o hnini."
"xi mi taxki ra ñ'u, imbi tsa da r'anga n'a, jo̱nse̱je̱ mi taxka n'a ja ra bo̱jai. ya y'ofadi mi kju̱t'atjo."	"xi mi taxki ra ñ'u, imbi tsa da r'anga n'a, honse̱je̱ mi taxka n'a ha ra bo̱jai. ya y'ofadi mi jut'atjo."
"ya dänga mfu̱nga bo̱kjä bi ntjo, bi kot'i ko ya majkjuai, mi zu̱m'i neje ko ya t'e̱nga ts'u̱t'abo̱kja."	"ya dänga mfu̱nga bo̱jhä bi ntjo, bi kot'i ko ya mahkjui, mi zu̱m'i nehe ko ya t'e̱nga ts'u̱t'abo̱kja."
ya r'atsanoya ra sajagún mi mä jankja mi yopa tsini. ya ndeznä bi nkoji inda ñ'udi. mi jatatjo pa bi mu̱di ra ntujni	ya r'atsanoya ra sahagún mi mä jankja mi yopa tsini. ya ndeznä bi nkoji inda ñ'udi. mi jatatjo pa bi mu̱di ra ntuhni
"ya zi b'e̱jña mi ägi ja ya b'a ne ja ya ngo̱de, nuya ñ'o̱jo̱ mbo ja ya ne, ja ya nkjom'ajudi."	"ya zi b'e̱hña mi ägi ha ya b'a ne ha ya ngo̱ho̱, nuya ñ'o̱ho̱ mbo ha ya ne, ha ya nkjom'ajudi."
"bi boxro xi 'be̱ts'ina, bido'u̱ ro 'yu̱ni 'na, xi bi bo̱x ro hkjua 'na, bido'u̱ ro ts'ii 'na, xi bo̱xro ts'äre 'na. ge'bu̱ go min pu̱n doja 'na."	"bi boxro xi 'be̱ts'ina, bido'u̱ ro 'yu̱ni 'na, xi bi box ro hkjua 'na, bido'u̱ ro ts'ii 'na, xi boxro ts'äre 'na. ge'bu̱ go min pun doja 'na."
bi ma mankjuäntjo jabu̱ mi b'u̱i ra ts'e̱y'e̱jmu bi xipabi;	bi ma mankjua̱ntjo jabu̱ mi b'u̱i ra ts'e̱y'e̱hmu bi xipabi;
bri kjuajni po nuya dra jmu.	bri juahni po nuya dra jmu.
"di to̱m'ihe ra ñ'etji pa nugagije, n'a ra pa ngu ma n'a ra pa tjogi nekagije di juadije ra nge'a indi tse̱tije nuna b'u̱i t'o̱t'e ko ngekagije man'año ya ntjo, t'e̱nts'igije tji ma jaije ma me̱tije, ju̱kagije ga mpe̱fije nduntji, b'e̱kagije ga jut'ije xduntji ya bokja, n'a ngu n'a ra pa nuna nkjut'i di o̱t'eje man'a te ma tjaije di tuje."	"di to̱m'ihé ha ñ'etji pa nugagijé, n'a ha pa ngu ma n'a ha pa thogi nekagijé di juadijé ha nge'a indi tse̱tijé nuna b'u̱i t'o̱thé ko ngekagijé man'año ya ntjo, t'e̱nts'igijé tji ma jaijé ma me̱tijé, jukagijé ga mpe̱fijé nduntji, b'e̱kagijé ga jut'ijé xduntji ya boja, n'a ngu n'a ha pa nuna nkjut'i di o̱t'ehé man'a te ma tjaijé di tujé."
gatjo nuna jai ja nuna r'ayo ximjai nkjabu̱ bi tjutuabi nuya nso̱jo̱jä'i inbi tsa bi tjutuabi man'a ra tjuju.	gatjo nuna hai ha nuna r'ayo ximhai nkjabu̱ bi thutuabi nuya nso̱ho̱jä'i inbi tsa bi thutuabi man'a ra thuju.
"ja mi tso nde, bi mu̱di bi nkja n'a ra jneki ngu nkjagiju̱ dega kjä'i, bi t'ot'e ra b'ai ngu dega kjä'i,"	"ha mi tso nde, bi mu̱di bi nka n'a ra jneki ngu nkjahiju̱ dega jä'i, bi t'ot'e ra b'ai ngu dega jä'i,"
"ma bo̱najmu'ije: nuna b'e̱fi ga tsokagije sta kjuatihe gatjo: gi nuti nuua, xa jño bo̱najmu."	"ma bonahmu'ije: nuna b'ehi ga tsokagije sta juatihe gatjo: gi nuti nuua, xa jño bonahmu."
"mi mä dega ts'e̱dira jñä tso̱pu da ts'o̱jo̱bu nuya nzo̱jo̱kjä'i ga jandiju̱ te ma ts'e̱di pe̱tsi, ra nge'a ma akjuä ra quetzalcohuatl b'u̱i nuua ko ngekagiju̱,"	"mi mä dega ts'e̱dira jñä tso̱pu da ts'o̱hobu nuya nzo̱hokjä'i ga handiju̱ te ma ts'e̱di pe̱tsi, ra nge'a ma akjuä ra quetzalcohuatl b'u̱i nuua ko ngekagiju̱,"
"ne ya nt'u̱i, jankja di tjuts'i ya nt'ofo, nkjap'u̱ neje mä 'ra ya mpeu̱i da fats'i di nt'ot'i ra jñäjñu"	"ne ya nt'u̱i, hankja di tsuts'i ya nt'oho, nkjap'u̱ nehe mä 'ra ya mpeu̱i da fats'i di nt'ot'i ra jñäjñu"
"nub'u̱ nu'i ingi kjapi da bo̱nga nu'a ra makja ja nu'a ra jnini, ¿jankja ra yotui, ga tso̱gi nubu̱ ma b'e̱jña? o̱t'a r'ato ya kje̱ya bi mu̱di [ra makja ra bartolomé lópez]"	"nub'u̱ nu'i ingi kjapi da bo̱hnga nu'a ra makja ha nu'a ra hnini, ¿jankja ra yotui, ga tso̱gi nub'u̱ ma b'e̱hña? o̱t'a r'ato ya kje̱ya bi mu̱di [ra makja ra bartolomé lópez]"
pa ga b'u̱i mpaja ne ga o̱t'e n'a ra nkjondajmä gatjo nu'a ga jandi.	pa ga b'u̱i mpaja ne ga o̱t'ehu n'a ra nkjondajmä gatjo nu'a ga handi.
"r'a nuna mi ntjandi ngu nu'a ma tjänkjuaju̱ (ychtlilmatli), xi mra nts'o, mi kuet'e ja ya ngo̱,"	"r'a nuna mi ntjandi ngu nu'a ma thänkjuaju̱ (ychtlilmatli), xi mra nts'o, mi kuet'e ha ya ngo̱,"
"xa zägi mpaja, nub'u̱ xa nkjabu̱ xa kjapabi ma zu ne inte xa t'o̱tuabi nub'u̱ inda kjapi xa po̱jo̱ bi ya kue̱ ra nge'a ya kjä'i xi mra no̱t'e ne mra jyotekjä'i,"	"xa zägi mpaja, nub'u̱ xa nkjabu̱ xa kjapabi ma zu ne inte xa t'otuabi nub'u̱ inda kjapi xa po̱ho̱ bi ya kue̱ ra nge'a ya jä'i xi mra no̱t'e ne mra jyotekjä'i,"
"y'o, ri ma ne gi xipabiju̱ ya metlaxcala ge ma r'a ya me̱ti kjä'i ne ri ajuäju̱, ge nu'a ga mä ge xa eje nuua ma jaiju̱, ge di umbabije ma ntjädije."	"y'o, ri ma ne gi xipabihu̱ ya metlaxcala ge ma r'a ya me̱ti jä'i ne ri ajuäju̱, ge nu'a ga mä ge xa ehe nuua ma jaiju̱, ge di umbabije ma ntjädije."
¿te da o̱t'e ma kjä'iju̱ sta b'e̱diju̱?	¿te da o̱t'ehu̱ ma jä'ihu̱ sta b'e̱dihu̱?
"-da ts'iua:... ri ñ'eje ge'a ma nkjueij'u̱. da o̱t'eje ya ñ'o̱te ko ya je̱m'i, ya ñ'o̱t'eje ko ya ntuts'i. da o̱ts'e̱ ra b'e̱na noya."	"-da ts'iua:... ri ñ'ehe ge'a ma nkjueij'u̱. da o̱t'ehu̱ ya ñ'o̱ho̱ ko ya he̱m'i, ya ñ'o̱t'ehu̱ ko ya ntuts'i. da o̱ts'e̱ ra b'e̱na noya."
-dom'i ma akjuäju̱ ge inda yu̱t'a ja ma nguju̱ nuju̱ to'o e̱nts'i pa tji ne da jokuabi ra jonanjyo nub'u̱ sta ne da jyoki ya inda za.	-dom'i ma akjuähu̱ ge inda yu̱t'a ha ma nguju̱ nuhu̱ to'o e̱nts'i pa tji ne da jokuabi ra jonanjyo nub'u̱ sta ne da jyoki ya inda za.
"-o̱t'a ra mäte gi o̱deju̱, kja gi b'ai nuuaju̱. mont'a ya ngo akjuä; ri kjuat'i ra ngo ga tsunda ma akjuäje."	"-o̱t'a ra mäte gi o̱dehu̱, kja gi b'ai nuuahu̱. mont'a ya ngo akjuä; ri juat'i ra ngo ga tsunda ma akjuäje."
"-xa jño, di b'u̱ije nkjamädije."	"-xa jño, di b'u̱ihe nkjamädije"
-¿nguande nkjabu̱ ga mäu gra kjuäju̱?	-¿nguande nkjabu̱ ga mäu gra juäju̱?
"-ñ'emabagi, ya gabida, ya kjä'iju̱ gi pädi ra ntuni ra mem'onda ba ejeju̱ ga te̱niju̱ma nzu̱teju̱. ko ya mätsa mi te̱je̱, ko ya bu̱'bai ko ngatjo ra ts'e̱di mi te̱je̱ ra ñ'u."	"-ñ'emabagi, ya gabida, ya jä'ihu gi pädi ra ntuni ra mem'onda ba eheju ga te̱nihu̱ma nzu̱tehu̱. ko ya mätsa mi te̱he, ko ya bu̱'bai ko ngatho ra ts'e̱di mi te̱he ra ñ'u."
"bi tse̱ti nuna ngot'i ra m'onda, ngu pede ra dänga b'ede, ya k'oi ne ya nkjändajmä, ngu nu'a ra jmä ra alonso axayaca, gojo n'ate ma pa bi nzo̱t'e nuna pa."	"bi tse̱ti nuna ngot'i ra m'onda, ngu pede ra dänga b'ede, ya k'oi ne ya nkjändajmä, ngu nu'a ra jmä ra alonso axayaca, gojo n'ate ma pa bi nzo̱t'e nuna pa"
"into y'o mankjuäntjo, into pa ri nektjo."	"into y'o mankjäntjo, into pa ri nehtjo."
"nub'u̱ ndi umbabije ma nkjut'ije xki nzäi ndi da'ije, mi adi n'a tu̱ki neje nub'u̱ ndi unije ya k'astaboja mi jäni made n'a tu̱ki [...]"	"nub'u̱ ndi umbabije ma nkjut'ije xki nzäi ndi da'ije, mi adi n'a tu̱ki nehe nub'u̱ ndi unije ya k'astaboja mi jäni made n'a tu̱ki [...]"
"ya miñ'o ko ngejna jmä ri kjojya,"	"ya miñ'o ko ngejna hmä ri johya,"
bi tso̱jso̱ ra ngo ma akjuäju̱: nubia da fu̱di da guadi ra r'e̱t'a ra pa.	bi tso̱hso̱ ra ngo ma akjuähu̱: nubia da fu̱di da guadi ra r'e̱t'a ra pa.