Input	Result
"-pasadores: ""ya nts'äza xi mra nts'u̱t'i mi t'e̱ni ko n'a ra t'e̱nga ts'u̱t'a bo̱kja mi tjutuabi ra ballesta""."	Ya ntśäza xi mra ntś'u̱ti mi t'ēni ko n'a ra t'ēnga ts'u̱ta bo̱kya mi tjutuabi ra balesta.
"cantares mexicanos, biblioteca nacional de méxico, ya nt'ofo 1628 bis, folio 16 v."	"Cantares mexicanos, biblioteca nacional de México, ya nt'öfö 1628 bis, folio 16 v."
"ebu̱ bi bo̱ni, bi meui nuni nonohualco, ja ra ngu ra b'ongui jabu̱ ra gabida ne ra malintzin ne ""ra jyadi"" (alvarado) ne ra sandoval."	"Ebú̱ bi bó̱ni, bi meui nuni nonohualco, ja ra ngu ra b'o̱ngui jabú̱ ra gabida ne ra malintzin ne ""ra jyadi"" (Alvarado) ne ra Sandoval."
gi jandi ra nt'ofo ra tjuju ra crónicas de la conquista	Gi xandi ra nt'oho ra xuxu ra crónicas de la conquista
"guzmán. ja ya je̱m'i b'e̱tsa kje̱ya manteb'u̱ di ge nuua m'onda ne ya jyo, nu'a ra jmä ra 12-conejo (1530) ge xa jmä ge xibú bi yut'i ja ra culhuacan ya ndeznä, nda pablo xochiquetzin, motelchiuhtzin ne ra guzman."	"Guzmán. Ja ya je̱m'i b'e̱tsa kje̱ya manteb'u̱ di ge nuua m'onda ne ya jyo, nu'a ra jmä ra 12-Conejo (1530) ge xa jmä ge xibú bi yut'i ja ra Culhuacan ya ndeznä, Nda Pablo Xochiquetzin, Motelchiuhtzin ne ra Guzmán."
"ja ga ñ'udiju̱ ra nt'ofo ya ñämfo̱ po ra ntjuts'i ra doctor garibay,"	"Ja ga ñ'uɟiju ra nt'ofu ya ñämfu po ra ntjuts'i ra doctor Garibay,"
ja nu'a jyodi nubia tjutuabi ra san martin.	Ja nu'a jyodi nubia tjutuabi ra San Martín.
"je̱mi unga mfädi ja ra t'u̱ka jnini jabu̱ b'u̱i ya kjä'i teni ra división ra arenas, 27 ra abril ra kje̱ya 1918, ra m'ets'a je̱m'i ra zapata, b'e̱tsi ja ra universidad nacional autónoma de méxico, expediente 29."	"Jëmi uŋga mfädi ja ra t'uka jnini jabu b'ui ya kjä'i teni ra división ra arenas, 27 ra abril ra këya 1918, ra m'ets'a jëmi ra Zapata, b'etsi ja ra Universidad Nacional Autónoma de México, expediente 29."
"m'e̱fa ja ra jñuti bri tjätuabi na ra jñe xki tagiri mo̱te, neje bri kjom'a ra xu̱tja ko n'a ra t'axa dutu mra tjujuu ra ""campanillante""."	"M'efa ja ra ñuti bri tätuabi na ra ñe xki tagiri mohte, neje bri kjom'a ra xutja ko n'a ra t'axa dutu mra tjujuu ra ""campanillante""."
"ma dada'ije gra ts'u̱tui, di ne gi pädi ge ma me̱t'o instä tjogije nuna tjogi gatjo ya mapa xki r'ani, bi kjuat'i ko ngeke nu̱'u ri b'e̱go, ri me̱fi ya ñämfo̱, ra nge'a makjuäni ra hernando cortés ra ndä gabida,"	"Ma dada'ije gra ts'utui, di ne gi pädi ge ma met'o instä tjogije nuna tjogi gatjo ya mapa xki r'ani, bi kjuat'i ko ngeke nu'u ri b'ego, ri mefi ya ñamfo, ra nge'a makjuani ra Hernando Cortés ra ndä gabida,"
mi b'u̱i ya mu̱dimejai mi ñä ra ndeznä ne jabu̱ ra jnini dige'a gatjo ra nxiki m'onda ngu r'a ya yaqui b'u̱i nuni sonora ne ya maya ri ñ'eje nuni yucatán ra nge bi guat'i ja ra tujni bi nkja nuua m'onda fädi ko ra tjuju ra revolución mexicana ya kje̱ya 1910-1919.	Mi bʼui ya mudimejai mi ñä ra ndeznä ne jabʼui ra jnini digeʼa gatjo ra nxiki mʼonda ngu rʼa ya yaqui bʼui nuni sonora ne ya maya ri ñʼeje nuni yucatán ra nge bi guatʼi ja ra tujni bi nkja nuua mʼonda fädi ko ra tjuju ra revolusión mexicana ya kjeʼya 1910-1919.
mi fo̱tuabi ya ts'u̱tnibo̱kja mi tjutuabi ya jñämfo̱ ra pasadores neje ya bo̱zna ko ya nzafi.	Mi fōṭuabi ya ts'ūṭnibōkja mi tjutuabi ya ñǵāmfō ra pasadores nehe ya bōzna ko ya nzafi.
"n'a nt'udi di ge'a nuya ntjoki bri t'o̱t'e ja ya jñä ya ndeznä ra ngätsi ra ntjebe nkje̱ya ra r'e̱t'a ma gu̱to (s. xix), r'a ya jnini ngu ra xicontepec (villa juárez) nuna jyodi koji nuni puebla."	"N'a nt'udi di ge'a nuya ntjoki bri t'o̱te ja ya jñä ya ndeznä ra ngätsi ra ntjebe nkje̱ya ra r'e̱ta ma gu̱to (s. xix), r'a ya jnini ngu ra xikontepec (Villa Juárez) nuna jyodi koji nuni Puebla."
"n'a ra t'axa dutu mi pe̱tsi ya k'oi ra ixki, nuna mra tjuju jñämfo̱ ""campaneante resonador""."	"N'a ra t'axa dutu mi pe̱tsi ya k'oi ra ixki, nuna mra tjuju jñämfo ""kampaneante resonador""."
"ne ri mpe̱fi ja ra dängan gu nt'udi ra tjuju ra facultad de estudios superiores, acatlán, unam,"	"Ne ri mpʉ̱hi ja ra däŋgaŋ gu nt'udi ra tʃuʃu ra Facultad de Estudios Superiores, Acatlán, UNAM,"
"ntjandi gatjo nu'a ra munts'i ra tjuju jñämfo̱ ra globalización ge 'a po̱ts'e dega nest'iji, nuna y'o̱te to̱m'i da nkja ra ntjo̱mäte."	"Ntjandi gato nu'a ra montsi ra tjiju jñamfo ra globalización ge 'a pots'e dega nest'iji, nuna y'ote tom'i da nkya ra ntjomate."
"nu'a ma r'a ya kjä'i mi pädi nuña b'e̱fi bri b'e̱pabi xa jyoki yojo ya mpe̱fi mi fädi ko ra tjuju ra amosqueador ko ya xi ya ts'ints'u̱ xi sta jotjo, gi jutsuabi made dige'a n'a ra zänä dega k'astabokja"	"Nua ma r'a ya kjä'i mi pädi nuña b'efi bri b'epabi xa jyoki yojo ya mpëfi mi fädi ko ra tjuju ra amoskeador ko ya xi ya ts'ints'u xi sta jotjo, gi jutsuabi made dige'a n'a ra zänä dega k'astabokja"
"nu'a ra munts'a kjä'i bi te̱ni bi zipabi man'a ya b'ede, mi t'ena ge ya kjä'i xki b'u̱i nubu̱ inbi pe̱tsi ra ts'e̱di nu'a mi mä pe m'e̱fa bi kjapi bi nxaxni ya tsu̱tui ne n'a ra diputado mi pe̱tsi ra mfeni xki kot'i mra tjuju ra josé maría lozano, bi y'onga ra jmä pa mar'a ya ñ'oui bi nxanxi: ""ri mo̱te ra tjits'i mi udi ra emiliano zapata, neje bri fädi ngu ra atila nuna bri nkju̱tsi [...] nu'a bi fädi ngu mi je̱gi ya b'e̱go ne'a bi mä da uni da nkja pa gatjo, ingi kjot'i [...]"	"Nua ra munts'a kjä'i bi teni bi zipabi mana ya b'ede, mi t'ena ge ya kjä'i xki b'u̱i nubui inbi petsi ra ts'e̱di nua mi mä pe m'e̱fa bi kjapi bi nxaxni ya tsu̱tui ne n'a ra diputado mi petsi ra mfeni xki kot'i mra tjuju ra José María Lozano, bi y'onga ra jmä pa mar'a ya ñ'oui bi nxanxi: ""Ri mo̱te ra tjits'i mi udi ra Emiliano Zapata, neje bri fädi ngu ra Atila nuna bri nkju̱tsi [...] nua bi fädi ngu mi je̱gi ya b'e̱go ne'a bi mä da uni da nkja pa gatjo, ingi kjot'i [...]"
nu'u̱ to'o ñä ra ndenzä ja r'e̱t'a ma r'at'o ya estados.	Nuu̱ to'o ñä ra nde̱nza ja r'e̱ta ma r'ato ya Estados.
"nub'u̱ ri m'e̱jni ne ri b'e̱go ya ñämfo̱ bi kjuat'i ko ngekagije ne bi tso̱jo̱ ra gabida ra tjuju ra hernán cortés, maske indi pädije ge gatjo da za da o̱t'e ne xi ra nzunda maría trinidad,"	"Nub'u̱ ri m'e̱jni ne ri b'e̱go ya ñämfo̱ bi kjuat'i ko ngekagije ne bi tso̱jo̱ ra Gabida ra Tjuju ra Hernán Cortés, maske indi pädije ge gatjo da za da o̱t'e ne xi ra Nzunda María Trinidad,"
"nubia, unga mfädi ja ra ñäjñu kjamädi ra universidad autónoma del estado de hidalgo."	"Nubia, unga mfädi ja ra ñäjñü kjamädi ra Universidad Autónoma del Estado de Hidalgo."
"nugi, ra miguel hernández ge di pe̱tsi ma ngu nuni chiyauhtzinco, ko ra t'ek'ei di udi ko nge'i, nuna m'e̱jnant'ofo di joki go tso̱n'i ko nge'i, ma t'ek'ei bo̱najmu'i nda doctor alonso ruiz, ra nk'ojnate ge gi b'ui nuua ja ra jnini ra quamochtitla."	"Nugi, ra Miguel Hernández ge di pe̱tsi ma ngu nuni Chiyauhtzinco, ko ra t'ek'ei di udi ko nge'i, nuna m'ejnant'ofo di joki go tso̱n'i ko nge'i, ma t'ek'ei bo̱najmu'i nda doctor Alonso Ruiz, ra nk'ojnate ge gi b'ui nuua ja ra jnini ra Quamochtitla."
"nuna je̱m'i bri t'unga mfädi ko ra t'u̱ka ntjint'ant'ofo po ra marcelo díaz salas ne ra luis reyes garcía ja: tialtocan, revista de fuentes para el conocimiento de las culturas indígenas de méxico, vol. vi, 1970, b'ede ra 3, pp. 193-212."	"Nuna hëmꞌi bri tꞌunga mfädi ko ra tꞌuꞌka ntshintꞌantꞌofo po ra Marcelo Díaz Salas ne ra Luis Reyes García ja: Tialtocan, Revista de fuentes para el conocimiento de las culturas indígenas de México, vol. VI, 1970, bꞌede ra 3, pp. 193-212."
"nuna jñäpi juts'i ja n'a ra je̱m'i fädi ra derecho canonigo ko ra tjuju jñämfo̱ ngu ra ""solicitación al administrar el sacramento de la confesión""."	"Nuna jñäpi juts'i ja n'a ra je̱m'i fädi ra derecho canonigo ko ra tjuju jñämfo̱ ngu ra ""solicitación al administrar el sacramento de la confesión""."
"nuna m'e̱jna nt'ofo b'e̱tsi ja ra archivo histórico nacional, madrid, documento 165. bi unga mfädi ja ra nt'ofo ya zubi po ra y'ofo ra tjuju ra arthur j. o. anderson et al.: byond the codices: the nahua view of colonial mexico, berkeley, university of california press, 1976, pp. 181-187."	"Nuna m'ëjna nt'ofö b'ëtsi ja ra Archivo Histórico Nacional, Madrid, documento 165. Bi uŋga mfädi ja ra nt'ofö ya zubi po ra y'ofö ra tjuju ra Arthur J. O. Anderson et al.: Beyond the Codices: The Nahua View of Colonial Mexico, Berkeley, University of California Press, 1976, pp. 181-187."
"nuna nt'ofo b'e̱tsi ja ra archivo general de indias, sevilla, audiencia de méxico 168, bi unga dra fädi po ra miguel león-portilla ja cultura en peligro, méxico, alianza editorial mexicana, 1976, pp. 102-103."	"Nuna nt'oho b'ëtsi ja ra Archivo General de Indias, Sevilla, Audiencia de México 168, bi unga dra fädi po ra Miguel León-Portilla ja Cultura en peligro, México, Alianza Editorial Mexicana, 1976, pp. 102-103."
"nuna pika je̱m'i kja te mä b'e̱tsi ja ra archivo general de la nación, nuua m'onda ne kja ja ra nduntji ya jnini, njabu̱ ngu ya nzaya nuni manjyati ne mar'a ya jnini, o̱t'e gi o̱de ra jñä ra mu̱dimejai."	"Nuna pika jë̱m'i kja te mä b'ë̱tsi ja ra Archivo General de la Nación, nuua m'onda ne kja ja ra nduntji ya jnini, njabü ngu ya nzaya nuni manjyati ne mar'a ya jnini, o̱t'e gi o̱de ra jñä ra mu̱dimejai."
"nuua t'unga yojo ya jmä, kuän'ajmä ya ndeznä ne tjuts'i ja n'a ra k'oi mä mäkjuäni ri ntje̱ui n'a ya dänga ra tju̱ajmä manteb'u̱, nuua pede nu'a gatjo ya ts'otjogi bi y'o̱t'a dega fete ra alvarado."	"Nuuá t'ungá yojo ya hmä, kuän'ajmä ya ndeznä ne tjuts'i ja n'a ra k'oi mä mäkjuni ri ntje̱ui n'a ya dängá ra tju̱ajmä manteb'u, nuuá pede nu'a gatjo ya ts'otjogi bi y'o̱t'a dega fete ra Alvarado."
"nuua ya mu̱di noya ra motolinia, ja ra mu̱di nkoji bi t'o̱t'e ko ra tjuju ra tratado tercero ra dänga b´ede ya mu̱dimejai nuua r´ayo manjyati:"	"Nüüa ya mǘdi noya ra Motolinía, ja ra mǘdi nkʼoji bi tʼǫtʼe ko ra tÿÿu ra Tratado Tercero ra Däŋga Bʼede ya mǘdimejai nüüa rʼayo manjyati:"
"pa da t'unga mfädi gatjo nu'u̱ bi nkja, n'a di ge'u̱ ko ngu fe̱ti nu'a makjuäni mi joki mi tjutsuabi ya jnei ne ya b'ida. b'u̱i man'a ra mfädi da t'o̱t'a ra nt'udi, nu'a ra tjuju ""fe̱ta nu'a makjuäni bi nja nub'u̱ ra tsokat'o̱tamfeni (teatro de la conquista)""."	"Pa da t'unga mfädi gatyo nu'u bi nkya, n'a di ge'u ko ngu feti nu'a makyuäni mi yoki mi tjutsuabi ya jnei ne ya b'ida. B'u'i man'a ra mfädi da t'o't'a ra nt'udi, nu'a ra tyuju ""feta nu'a makyuäni bi nja nub'u ra tsokat'o'tamfeni (teatro de la conquista)""."
"ra europa -mra nxika jai manteb'u̱, mi pe̱tsa n'a ra nxika b'ede-"	"Ra Europa -mra nxika jai manteb'u, mi pe̱tsa n'a ra nxika b'ede"
"ra fernando ramírez mä ge nuna jyodi ri nge̱pu̱ jabu̱ kja n'a ra nikja ra san fernando ne ra ermita dige'a ya mártires dige'a san hipólito,"	"Ra Fernando Ramírez mä ge nuna jyodi ri ngë̱pu̱ jabu̱ kja n'a ra nikja ra San Fernando ne ra Ermita dige'a ya Mártires dige'a San Hipólito,"
"ra fernando de alva ixtlilxóchitl, fernando de, xiii relación: ""ra ñ'eje ya ñämfo̱ ne ra fu̱di ra nkanfri ra evangelio""."	"Ra Fernando de Alva Ixtlilxóchitl, Fernando de, XIII relación: ""Ra ñ'eje ya ñämpfo ne ra füdi ra nkänfri ra evangelio"""
"ra kuän'ajma ra n luz jiménez bi juts'i ra fernando horkasitas bi unga mfädi ne bi r'atsi nuña jmä), de porfirio díaz zapata, memoria nábuatl de milpa alta, méxico, unam,, instituto de investigaciones históricas, 1974, p. 105"	"Ra kuän'ajma ra n luz jiménez bi juts'i ra fernando horkasitas bi uŋga mfädi ne bi r'atsi nuña jmä, De Porfirio Díaz Zapata, Memoria náhuatl de Milpa Alta, México, UNAM, Instituto de Investigaciones Históricas, 1974, p. 105"
"ra raymundo isidro alavez, bi b'u̱i'i nuni ra boxtha chico, san salvador, estado de hidalgo"	"Ra Raymundo Isidro Alavez, bi b'üi'i nuni ra boxtha chico, San Salvador, Estado de Hidalgo"
"ra jmä ra fundación de santo tomás ajusco, archivo general de la nación, méxico, ramo de tierras vol. 2676, expediente. 4, archivo histórico de la biblioteca nacional de antropología, colección antigua, vol. 254, fojas 259 r.- 260 v."	"Ra jmä ra Fundación de Santo Tomás Ajusco, Archivo General de la Nación, México, Ramo de Tierras vol. 2676, expediente 4, Archivo Histórico de la Biblioteca Nacional de Antropología, Colección Antigua, vol. 254, fojas 259r - 260v."
"ra makja mra tjuju ra toribio benavente, motolinia,"	"Ra makja mra tjiju ra Toribio Benavente, Motolinia,"
"tlauhquechol: ra ts'ints'u̱ xa ntjeni pode ge'a ra flamenco o ra guacamaya, pode ge gatjo ra tje̱nga ts'ints'u̱ ne dänga."	"Tlauhquechol: ra ts'ints'u xa ntjeni pode ge'a ra flamenco o ra guacamaya, pode ge gatyo ra tjenga ts'ints'u ne danga."
"xkri tso̱ngä ngostji, kja jejni ya 'ñu; nä'ä rí ma nxamädo, ja nä'ä rí ma mäbo̱za. antes de"	"Xkri tsongä ngotsi, kja jejni ya 'ñu; nä'ä rí ma nxamädo, ja nä'ä rí ma mäboza."
"ya b'e̱go ne ya b'e̱tri di ge'a nu'a ra dänga ndä ra ndada ra tjuju ra esteban de guzmán ra nzaya di gekua m'onda, ra ndada ra hernando pimentel, ra ndada ra antonio cortés, ra ndada xuua (juan) nuna ra mecoyoacan, ra ndada pedro motecuhzoma, me ma r'a ya kuänmi (firmas)."	"Ya b'e̱go ne ya b'e̱tri di ge'a nu'a ra däŋga ndä ra ndada ra tjuju ra Esteban de Guzmán ra nzaya di gekua m'onda, ra ndada ra Hernando Pimentel, ra ndada ra Antonio Cortés, ra ndada xuua (Juan) nuna ra Mecoyoacan, ra ndada Pedro Motecuhzoma, me ma r'a ya kuänmi (firmas)."
"ya kuän' ajmä xa tjogi manteb'u̱e ge xa tjäst'i nu'a gatjo ra ntjandi to'o bi b'e̱di ge xa pu̱ngajñä nuna jmä getbu̱ n'ate ya jñäki ge ñä ya nso̱jo̱ jñäki ne xa y'oni nuna nt'ofo neje ja ra jñäki yazi xada kjä'i , ge'a nuna jñäki fadi ja ra jñämfo ko ra tjuju ra sistema braile."	"Ya kuän' ajmä xa tjogi manteb'u̱e ge xa tjästi nu'a gatjo ra ntjandi to'o bi b'edi ge xa pu̱ngajñä nuna jmä getbu̱ n'ate ya jñäki ge ñä ya nso̱jo̱ jñäki ne xa y'oni nuna nt'ofo neje ja ra jñäki yazi xada kjä'i, ge'a nuna jñäki fadi ja ra jñämfo ko ra tjuju ra sistema braille."
"ya r'atsanoya ra sahagán, ndoxkjua k'oi florentino, lib. xii, caps. xxix-xli (versión de ángel ma. garibay k.)."	"Ya r'atsanoya ra sahagán, ndojkjua k'oi Florentino, lib. XII, caps. XXIX-XLI (versión de Ángel M.a Garibay K.)."
despwés ya desde k'a ra momento ya k'a ya jíngi bénya'wi já té bimáju̱ k'a ra charroya'wi	Despwés ya desde k'a ra momento ya k'a ya xíngi bénya'wi xá té bimáju̱ k'a ra charroya'wi
despwés ya xo bimu̱fí pe xo diario diario bu̱ nchúi mitsu̱ k'a ra charro mi'óbí k'a ra mikwála	"Despwés ya xō bimūfí pe xō diario, diario bu ōnch’uí mitsū k’a ra charro mi’ōbí k’a ra mikwála"
goparejájé primero 'á k'a ra parte ánk'ú dínant'í	Goparejájé priemeru 'á k'a ra parte ánk'ú dinant'í
i asta fecha pues ignoro mucho pero másk'ŭ mäkjámá más ndímáignorajéwi	i asta fecha pues ignoro mucho pero máskŭ mäkjámá más ndímá ignorajéwi
indu̱odiagí bastante	indu̱odiagí baxte
"inga se̱je̱ ra nntjandi ra manjyati ne ra portuguesa neje ra francesa, inglesa, alemana e italiana,"	"Ingá séʔjeʔ ra ntjándi ra manjyáti ne ra portuguesa neʔje ra francesa, inglesa, alemana e italiana,"
k'a mädämé para ke mantenigíjé dígotjó mäbäjtsí pues ni modo dísufréjé	"k'a maxämé para ke mantenijyé digotjo mäbäjtsi, pues ni modo disuxré"
kómá'u̱té ya fuente níjí	Komá'uté ya fuente njí
"ne bi unbabi nduntji ya baba, bi enbabi ge mi ne da ñäui ra ndä (emperador) mi b'u̱i nuni manjyati, ne da jäni ra dänga ts'ofo ra evangelio,"	"Ne bi ūbabi nduntji ya baba, bi ēnbabi ge mi ne da ñäui ra ndä (emperador) mi b'ūi nuni manjyati, ne da jäni ra däŋa ts'ōfo ra evangelio,"
normalmente gójo	normalmente góhjo
panteón ga dó	Pantéon ga dó
pero de sesenta pantsítjá pa gotjók'ŭ kompletamente xatjó ndímáfădijé	Pero de sesenta pantsítja pa gotjók'ŭ kompletamente xatjó ndímáfadijé
pero eso sí binújgí mängŭjé kada ná	Pero eso sí binüjgi mängüje kada na
"po nuya kja'i to'o mi pede ge fädi ko ra tjuju ya ""cronistas de las indias”"	"Po nuya kja'i to'o mi pede ge fädi ko ra tjuju ya ""cronistas de las Indias”"
pues este kábádá balewa este mínimo siento sinkwenta	Pues este kabada balewa este mínimo siento sinkuenta
pues nimodo bisufré k'a más ante mäabwelitajé komo mbu̱i enkajoso ra ntsoya	pues nimodo bisufré k'a más ante mäbwelitajé komo mbui enkajoso ra ntsoya
"ra nku̱t'i ra juajni ne ya ñ'udi ntjutsi ra agustin yáñez 2da. edición. biblioteca del estudiante universitario, unam, 1950."	"Ra nkʉ̱ti ra xʉaxni ne ya ǵui ntʉtʃi ra Agustín Yáñez. 2da edición. Biblioteca del Estudiante Universitario, UNAM, 1950."
solamente ya riko alkansabi	Solamente ya ríko 'alkansabi
xi ra tí na ta komedór 'á itsí na ta alimento k'a ra ndăni	Xi ra tí na ta komedor 'á itsí na ta alimento k'a ra ndani
xo mitajá ra ntsoya mitá sínko pesos ra béjña dos sinkwenta	Xo mitajá ra ntsoya mitá síngko pesos ra béjña dos sinkuenta
xo takja mä sesenta wik'a takja mä sesenta bitajkíjéya'wik'a	Xo takya mä sesenta wika takya mä sesenta bitaxkíyeya'wika
á panteón ga dó níjí	Á panteón ga do njiji
ñúdigejña dabadijíya' razo''ya' mientra más dandu̱jté	ñudiejni dabadjíya' razó'ya' mientra máj dandujté
"-nu'u̱ dige'u̱ b'u̱i nuni maxey (tolimán ne amealco), dige'u̱ temoaya nuni ra ra jyodi estado de méxico ne mar'a ya jyodi nuni puebla ne veracruz"	"Nu'u̱ dige'u̱ b'ui nuni maxei (Tolimán ne Amealco), dige'u̱ Temoaya nuni ra ra jyodi Estado de México ne mar'a ya jyodi nuni Puebla ne Veracruz"
"ne mätajekitjo di kja getbu̱, ra jñäpi ra joel martinez hernández ne ra jotjo tjuajmä ra natalio hernández xocoyotzin, nuya yojo ya xajnate ri ñ'eje ya y'u̱ dige'u̱ ya ndeznä."	"Ne mä'tajekiti di kya getbũ, ra jñä'pi ra joel martinez hernández ne ra jotjo tjuajmä ra natalio hernández xocoyotzin, nu'ya yojo ya xajnate ri ñ'eje ya y'u dige'u ya ndeznä."
"-n'ate pa n'a ra zänä de ra r'e̱t'a ma jñäto ""zänä"" mi zo̱ta ya munts'i ya n'ate ya pa ge mi joki ra xihuitl o ""ra m'ede ra kje̱ya"""	"N'ate pa n'a ra tsänä de ra r'öt'a ma jñäto ""tsänä"" mi tsota ya munts'i ya n'ate ya pa ge mi joki ra xiuitl o ""ra m'ede ra këya"""
bi ma di gepu̱ jam''u̱ ra ngo pa da ts'itje ya it'adeje (Tlahuano) ba po̱ni nubu̱ tlapechhuan. mra ngo ra izcalli.	Bi ma di ɣepũ jamʼũ ra ŋo pa da tsʼitʃe ya itʼadeje (Tlahuano) ba põni nubũ tlapetʃhuan. Mra ŋo ra izkali.
bi mu̱di da jyoka ya t'u̱kats'u̱fabo̱kja. ge'a ra ntujni bi nkja nuni Coyohuehuetzin ne ma gojo ba nkja.	Bi mǘdi da ǵyoka ya t'ǘkats'ǘfabǘkǵa. Ge'a ra ntǘjni bi nkǵa nuni Coyohuehuetzin ne ma gojo ba nkǵa.
"bri tjo ra cuauhnochtli, ra gabida tlacatecco, ra cuapan, ra gabida huitznáhuac, ra makja Amantlan, ne ra makja tlacopan."	"Bri tjo ra cuauhnochtli, ra gabida tlacatecco, ra cuapan, ra gabida huitznáhuac, ra makja Amantlan, ne ra makja Tlacopan."
bri ts'u̱tuabi ja ra y'u̱ga n'a ra nto̱de dega t'u̱ka joga do dega chalchihuite: made mi juts'i n'a ra tsant'i dega k'astabokja.	Bri ts'utuabi ja ra y'uga n'a ra ntode dega t'uka joga do dega chalchihuite: made mi juts'i n'a ra tsanti dega k'astabokja.
"Castañeda, ra t'u ra Aquiyahualcatecuhtli, m ra ndä nuni tlaxcala."	"Castañeda, ra t'u ra Aquiyahualcatecuhtli, mʔra ndä nuni Tlaxcala."
Coaíhuitl mra gabida ndeznä nuya mapa digeá ra t'o̱t'ats' okamfeni.	Koáiuitl mra gabida ndeznä nuya mapa digeá ra t'o̱t'ats'o kamfeni.
di gepu̱ ba koi pa nuni ra Xochimilco. nubu̱ ba tu ya kjä'i ya metlatelolco	Di hëpu̱ ba koi pa nuni ra Xochimilco. Nuhu̱ ba tu ya kjä'i ya Metlatelolco
"ebu̱ ba eje man'aki ba te̱nga ra t'o̱jo̱ ra tjuju ra Citlaltépec. Tlacopan, nubia ba o̱t'ra b'u̱i ja ra ndo̱m'ijmu."	"Ebu̱ ba ehe man'aki ba te̱nga ra t'o̱jo̱ ra tjuju ra Tsitlaltépetzi. Tlakopan, nubia ba o̱t'ra b'u̱i xa ra ndo̱m'ijmu."
ebu̱ bi dädi ra Cihuacóatl:	Ebu̱ʼ bi dädi ra Cihuacóatl:
ebu̱ bi ñä ra Cuauhtémoc bi xipabi ra Cihuacóatl:	Ebú̱ bi ñä́ ra Cuauhtémoc bi xipabi ra Cihuacóatl:
"gojo n'ate ya pa ne ebu̱ bi yopa bo̱ni pa di mani ra Huaxtepec, ra Cuauhnahuac (Cuernavaca)."	"Gojo n'ate ya pa ne ebu̱ bi yopa bo̱ni pa di mani ra Huaxtepec, ra Cuauhnahuac (Cuernavaca)."
"gue dá nhuat'i mbo kja ra ximjai,"	"nde dá ñuat'i mbo kja ra shimjai,"
"i nte ra nge'a, ya jmä juts'i ja ra ndäxkjua k'oi ra códice ra ramírez uni nuna b'e̱de mä makjuäni ngu mä ra ntje̱ka b'ede ne ra ndädi nu'a ra nänä mra tjuju ra yacotzin, ra nänä ra ixtlilxóchitl,"	"Intera ngæ'a, ya hmæ juts'i ja ra ndæxkjua k'oi ra códice ra Ramírez uni nuna b'æde mæ makjuæni ngu mæ ra ntjæka b'ede ne ra ndædi nu'a ra nänæ mra tjiju ra Yacotzin, ra nänæ ra Ixtlilxóchitl,"
"inda jyo ko ra ndäxjua ixtlilxóchtil, ra dada ra Nezahualcóyotl ni ko ra fernando de alva ixtlilxóchitl."	"inda jyo ko ra ndäxjua ixtlilxóchtil, ra dada ra Nezahualcóyotl ni ko ra Fernando de Alva Ixtlilxóchitl."
"k o ya bu̱' bai, ko ya makahuai,"	"ko ya bʉ̱ʔ bai, ko ya makahʉai,"
"mi fudi da t'axka ra xudi ba ts'i, bri tját'a ja n'a ra za mi b'ai ja ra ngu ra Ahuizotzin nuni ra Acatliyacapan."	"Mi hudi da t'axka ra xudi ba ci, bri tját'a ja n'a ra za mi b'ai ja ra ngu ra Ahuizotzin nuni ra Acatliyacapan."
mi gu̱t'a ra ñ'u̱ n'a ra makja ge'a mra b'e̱fi mi zu nu'a ra mäka jai mra tjuju ra Yohualichan.	Mi ndo̱hti ra ñ'u̱ n'a ra makja ge'a mra be̱fi mi zu nu'a ra mäka jai mra tjuju ra Yohualichan.
"mi y'o y'oua, mi tuts'i ya bu̱'bai dega za, ne r'a mi jä dega bo̱ja ne ya mahuai."	"Mi y'ó y'oua, mi ts'uts'i ya bǔ'bai dega za, ne r'a mi jä dega boǵa ne ya mahua'i."
mra ngu ra Aztautzin ge'a mi kja getbu̱ nuni ra Amáxac.	Mra ngu ra Aztautzin ge'a mi kja getbũ̈ nuni ra Amáxak.
n'a ra jyo ne man'a bi xokuabi ra debi. ra Cuauhtemoctzin bri xokuabi ra debi ge'a se̱je̱.	N'a ra ʒyo ne mana bi xokuaʒbi ra debi. Ra Cuauhtemoctzin bri xokuaʒbi ra debi ge'a seʔe.
"ne m'e̱fa bi ma xki jäki ya je dega magabi, ñätsi bi ntsaya ra mahuai ne ra bu̱'bai, bri nkjonda ya bo̱najmu nuni Acachinanco."	"Ne m'efa bi ma xki jäki ya je dega magabi, ñätsi bi ntsaya ra mahuai ne ra bu'bai, bri nkjonda ya bonajmu nuni Acachinanco."
"ne nkjabu̱ bri t'ot'e neje ko mar'a ya bo̱najmu mi pe̱tsi ra t'u̱ka tsu̱tui ja ya t'u̱ka jnini, nuyu̱ to'o mi b'e̱pi da t'o̱t'e ngu nuni Xalapan, Tlaxcalan, Tehuantepec, Oaxaca neje mar'a ya bo̱najmu mar'a ya t'u̱ka jnini jabu̱ bi guat'i ya nduste, ya dumantjuju dega k'astaboja, ge ya tjuju ya kristiano [...]"	"Ne nkjabu̱ bri t'ote neje ko mar'a ya bonajmu mi petsi ra tu̱ka tsutui ja ya tu̱ka jnini, nuyu̱ to'o mi be̱pi da to̱te ngu nuni Xalapan, Tlaxcalan, Tehuantepec, Oaxaca neje mar'a ya bonajmu mar'a ya tu̱ka jnini jabu̱ bi guati ya nduste, ya dumantjuju dega k'astaboja, ge ya tjuju ya kristiano [...]"
"ne nu'a ri däme, pu̱ ñ'a'i, nugi ga ma ga tsogi'i nuni Cuetlachcoapan [n'a ra jnini nuni puebla],"	"Ne nu'a ri däme, pu ñ'a'i, nugi ga ma ga tsogi'i nuni Kuetlachkoapan [n'a ra jnini nuni Puebla],"
"ne nu'u̱ bi mani dra ts'okat'o̱t'amfeni nuni Michoacán, Xalisco, Culhuacan ne nuni neje Pánuco, ne nuni Oaxaca, Tehuantepec ne Guatemala, ne nuua ra r'ayo majyati, nub'u̱ bri t'o̱t'a ra mabagi pa dra uadi dra t'o̱t'a nu'a ra ts'okat'o̱t'amfeni inda tsogije se̱je̱."	"Ne nu'u̱ bi mani dra ts'okat'o̱t'amfeni nuni Michoacán, Xalisco, Culhuacán ne nuni neje Pánuco, ne nuni Oaxaca, Tehuantepec ne Guatemala, ne nu'a ra r'ayo majyati, nub'u̱ bri t'o̱t'a ra mabagi pa dra uadi dra t'o̱t'a nu'a ra ts'okat'o̱t'amfeni inda tsogiye se̱ye̱."
"nejege'a ra ngätsi. mi jä ya mpe̱fi dega mabagi,ya nkjom'a te ne ya fu̱nbo̱kja, inte ma mahuai mi jä ni ge'a ya bu'bai."	"Nehege'a ra ngätsi. Mi jä ya mpe̱fi dega mabagi, ya nkjom'a te ne ya fu̱nbo̱kja, inte ma mahuai mi jä ni ge'a ya bu'bai."
njabu̱ bi bo̱nga dega xui. mra ngo nub'u̱ ra Tecuílhuitl bi bo̱nga: nub'u̱ bi kja ya du ja ra r'ani ra deje ya u̱erna.	Njäbü ŋo bōŋga dega xui. Mra ŋgo nub'ü ŋa Tecuílhuitl bōŋga: nub'ü ŋo kja ya du ja ra r'ani ra deje ya ü̈rna.
"nub'u̱ bi tjandi ra Tzihuacpopoca, bi t'ena:"	"nub'u̱ bi txandi ra Tzihuacpopoca, bi t'ena:"
"nub'u̱ ya ñämfo̱ bi handi ge xa ñ'ehe nubu̱ da tsu̱di, ge mi tekuabi ra nest'ihi, m'estho bi munts'i bi mihi ya mahuai."	"Nub'u̱ ya ñäm̱fo̱ bi handi ge xa ñ'ehe nuḇu̱ da tsu̱di, ge mi tekua̱bi ra nest'ihi, m'esto bi munts'i bi mihi ya mahuai."
"nuna jä'i inbi tsa bi thädi majuäni nu'a ra nt'ani. ingra nge'a nuya pa bi hneki n'a ra hyoya jä'i ra macehual (hombre de pueblo),"	Nuna hä'i inbi tsa bi thä'i majwäni nu'a ra nt'ani. Ingwa ngä'a nu'ya pa bi hneki n'a ra hyo'ya hä'i ra macehual (hombre de pueblo)
"nuna nte̱nga b'ede ha bri hat'i ra Tzihuacpopocatzin, bi o̱t'e da thogi ge'a ra ts'e̱y'e̱hmu. inbi bo̱nga nuna nt'o̱t'e bi tsu̱dihu̱ ko ma r'a ya b'e̱hni. ma ra ya ñ'ete inbi hopi da ju̱ man'aki ra ñ'u nuya ts'okate. pe nuya inbi hoki ra b'ai."	"Nuna ntʔenga bʔede ha bri hatʔi ra Tzihuacpopocatzin, bi oʔtʔe da togi geʔa ra tsʔeyʔemu. Inbi boʔnga nuna ntʔoʔtʔe bi tsudihu ko ma rʔa ya bʔehni. Ma ra ya ɲʔete inbi hopi da hu manʔaki ra ɲʔu nuya tsʔokate. Pe nuya inbi hoki ra bʔai."
"nuua di udihe ra hñäpi bi nto̱t'e bi nja ra agosto ra je̱ya 1595, n'a ra jä'i mra thuhu ra miguel hernández, ra me Chiyauhtzinco,"	"Nuuá di udihe ra hñäpi bi nto̱t'e bi njá ra Agosto ra ye̱ya 1595, n'a ra jä'i mra thuhu ra Miguel Hernández, ra me Chiyauhtzinco,"
nuya bo̱nahmu ya mem'onda ñätsi bi ñäui ra Cihuacóatl Tlacotzin m'estho bi thädi:	Nuya bo̱nahmu ya mem'onda ñätsi bi ñäui ra Cihuacóatl Tlacotzin m'esto bi thädi:
ra Tlacatécatl mra me Cuauhtitlan ne ra bktri ra mbot'a ngu bri japi ya tsat'yo bi zi.	Ra Tlakatekatl mra me Kowaxtitlan ne ra paktri ra mbota' ngu bri jabi ya tsat'yo bi zi.
ra doy'e̱ pahni xki njom'i ko ya chalchihuite.	Ra doy'e̱ pahni xki njom'i ko ya chalchiuite.
"ra mu̱di ra Cuauhtémoc, ra hmu ra bondo, ra nyoho ra Tlacotzin, ra Cihuacóatl ra nhñu ra oquiztzin, ra bo̱nahmu ha ra nini ra Azcapotzalco Mexicapan, ra ngoho ra panitzin, ra bo̱nahmu nuni ra Ecatepec,"	"Ra mǘdi ra Cuauhtémoc, ra hmu ra bondo, ra nyoho ra Tlacotzin, ra Cihuacóatl ra nhǘ ra oquiztzin, ra bǘnahmu ha ra nini ra Azcapotzalco Mexicapan, ra ngoho ra panitzin, ra bǘnahmu nuni ra Ecatepec,"
"ra mu̱di ra pa mi o̱t'e ra ngo ra mäkime ra u, ra thuhu ra Huixtocihuatl"	"Ra mudi ra pa mi ote ra ngo ra makime ra u, ra t'huhu ra Huixtocihuatl"
ra nge'a bi mu̱ni ko ra mahuai ha ra xu̱tha nu'a to'o bi umbabi ra ji.	Ra ngë'a bi muni ko ra mahui ha ra xutha nu'a to'o bi umbabi ra ji.
"ra nyoho, bi tho ra ndä ra Nauhtla, mra thuhu ra Cohualpopocatzin."	"Ra ñoʰo, bi tho ra ndäʰ ra Nauhtla, mra thuʰu ra Cohualpopocahtzin."
"unga ya ngue̱nda te ra ts'omu̱i mi bu̱'i ne mi japi da ntso̱m'i nuya macehualtin, njabu̱ mi thutuabi ya jä'i mi b'u̱i te ma za"	"Ŋga ya ŋɛ̈nda te ra c'omu̱i mi bʉ'i ne mi japi da ncɔ̱m'i nuya macehualtin, njabʉ mi thutuabi ya jä'i mi bʉ'i te ma za"
"xib'u̱ bri fádi ge nuya he mi ja nuni ra cuauhchichilco, ha Xaltocan; ge mi pttsi ya ndá."	"Xib'u̱ bri fádi ge nuya he mi xa nuni ra cuauhchichilco, ha Xaltocan; ge mi ptsi ya ndá."
"xki mbo̱ni nubu̱ ra hyodi ra Cuehuecatitlan,"	"xki mbøni nubø ra hyodi ra Kʉehʉekatitlan,"
"xki thete ra Ixtlilxóchitl ne ra ku ra Cohuanacotzin ko ya he dega dänga ndä bi mu̱di da häni ra hoga ts'ofo ya evangelio,"	"Xki thete ra Ixtlilxóchitl ne ra ku ra Cohuanacotzin ko ya he dega däŋga ndä bi mũdi da häni ra hoga ts'ofu ya evangelio,"
"ya dänga ñu̱ni nsafi, ya nsafi, ya mahuai, hangu nu'u̱ gatho xki tagi mbo ha ra hñe."	"Ya däŋga ñuni nsahi, ya nsahi, ya mahuai, hangu nu'u gatho xki tagi mbo ha ra hñe."
"bi o̱tuabi nu'a ra makja xki nk'ohni mra thuhu ra alonso ruiz, ge mi y'o nuni huamuxtitan (Huamuxtitlan) nuni ra hyodi guerrero."	"Bi o̱tuabi nu'a ra makya xki nk'ohi mra thuhu ra Alonso Ruiz, ge mi y'o nuni Huamuxtitlan nuni ra Hyodi Guerrero."
"di pädi xahño nuna b'e̱fi nehe yoho to'o di pädi da mpe̱fi da y'este nuya hoga do mahye̱gi ya xito, mra thuhu ra ambetz'ihuay."	"Di pädi xahño nuna b'ëfi nehe yoho to'o di pädi da mpëfi da y'ëste nuya hoga do mahyëgi ya xito, mra thuhu ra ambëtz'ihuay."
"dra thoki ra nto̱de, ra ketzal dra b'e̱ nuni Coyohuacan."	"Dra thoki ra ntōde, ra këtzal dra b'e̱ nuni Coyohuacan."
e mi r'ani dega xui ra Cihuacóatl g'ea mi zoni ne mı mafi.	E mi r'ani dega xui ra Cihuacóatl g'ea mi zoni ne mı̄ mafi.
"ebu̱ bi gäi habu̱ mi to̱ge ebu̱ bi yopa ma ha ra hnini ra Cuetaxtlan,"	"Ebú̱ bi gäí habú̱ mi to̱gé ebú̱ bi yópa ma ha ra hníni ra Cuetaxtlán,"
"ge'a ra mu̱di ra thuhu ra Hernando, ra nge'a njabu̱ mra thuhu ra takjä ra Cortés nehe njabu̱ mra thuhu ra ndä católico ne ra ku ra Cohuanacotzin bi thutuabi ra Pedro po ra Pedro Alvarado ra nge'a ra takjä,"	"Ge'a ra mũdi ra t'uhu ra Hernando, ra nge'a njabũ mra t'uhu ra tajä ra Cortés nehe njabũ mra t'uhu ra ndä católico ne ra ku ra Cohuanacotzin bi thutuabi ra Pedro po ra Pedro Alvarado ra nge'a ra tajä,"
"ma n'a mi b'ai nuni teotletso, habu̱ ra ñ'u̱ pa manjuäntho pa da zo̱ni nuni ra peñón (Tepetzinco)."	"Ma n'a mi b'ai nuni teotlétso, habũ ra ñ'u pa manjuantho pa da zõni nuni ra peñón (Tepetzintco)."
"mi tso̱ho̱ getbu̱ ra fu̱nga t'o̱ho̱, habu̱ mi thutuabi ""tajón ra nxu̱ni, njabu̱ bi hutuabi ya ndeznä ya b'e̱hnanoya bi pe̱hni ra ts'e̱y'e̱hmu, mi gu̱t'a ra ñ'u ra Tzihuacpopocatzin, bi bo̱nga ha ra ñ'u."	"Mi tso̱ho̱ getbu̱ ra fu̱nga t'o̱ho̱, habu̱ mi thutuabi ""tajón ra nxu̱ni, njabu̱ bi hutuabi ya ndeznä ya b'e̱hnanoya bi pe̱hni ra ts'e̱y'e̱hmu, mi gu̱t'a ra ñ'u ra Tzihuacpopocatzin, bi bo̱nga ha ra ñ'u."
mra ku ra Cacamatzin mra bo̱nahmu nuni Tetzcoco mri ñ'oui va jä'i mi y'o mpaha.	Mra ku ra Cacamatzin mra bo̱nahmu nuni Tetzcoco mri ñ'oi va jä'i mi y'o mpaha.
"n'a ra nto̱de dega chalchihuite, xi m'et'e dega ze̱ka do, nehe mi pe̱tsi n'a ra tsant'i de ga k'astaboja."	"N'a ra ntōde dega chalchihuite, xi m'et'e dega zēka do, nehe mi pētsi n'a ra tsanti de ga k'astaboja."
ne ndunthi ya ambetz'ihuay ne mar'a hoga do mi pe̱tsi ra mu'ui:	Ne nduthi ya ambejts'ihuaj ne mar'a hoga do mi pe̱ts'i ra mu'uj.
nehe n'a ya the̱sthi dega mboťahuaido.	Nehe n'a ya thę̱sti dega mbotohaiðo.
"nuna bi o̱t'a ra ntso̱m'i ra nge'a nehe nuya ya b'e̱datsi bi tsini ko ra Cortés ne ra Cohuanacotzin ne ra ixtlilxóchitl xki nsofo pa ra ixtlilxóchitl da gu̱ka ya jä'i ge mi zu ya hyodi, njabu̱ mi pe̱hna ajuä da t'o̱t'e."	"Nuna bi o̱t'a ra ntso̱m'i ra nge'a nehe nuya ya b'e̱datsi bi tsini ko ra Cortés ne ra Cohuanacotzin ne ra Ixtlilxóchitl xki nsofo pa ra Ixtlilxóchitl da gu̱ka ya jä'i ge mi zu ya hyodi, njabu̱ mi pe̱hna ajuä da t'o̱t'e."
"nuna nt'o̱t'e bi nthandi xa nts'ogi njabu̱ bri thutuabi, bi ena ge mra nzu̱te ko ma m'u̱hai ra nzu̱te ne mi thutsuabi ko ya mpe̱bi dega mabagì, habu̱ hmä ge n'a di ge'u̱ bi y'e̱nga n'a ra do, ko nge'a bi hyo, nu'u̱ mar'a ya b'e̱go ge mä ge nu'u̱ se̱he̱ ya ñämfo̱ bi hyo bi mu̱tu'a n'a ra mahuai ha ri ngati bi mu̱tuabi n'a ra nzu̱ni."	"Nuna nt'o̱hte bi nthandi xa nts'ogi njabu̱ bri thutuabi, bi ena ge mra nzu̱te ko ma m'u̱hai ra nzu̱te ne mi thutsuabi ko ya mpe̱bi dega mabagi, habu̱ hma̱ ge n'a di ge'u̱ bi ye̱nga n'a ra do, ko nge'a bi hyo, nu'u̱ mar'a ya be̱go ge ma̱ ge nu'u̱ se̱he̱ ya ña̱mfo̱ bi hyo bi mu̱tu'a n'a ra mahuai ha ri ngati bi mu̱tuabi n'a ra nzu̱ni."
"ra Cuauhtémoc, Tlacotzin, ra Cihuacóatl, Oquiztzin, Panitzin, Motelhuihtzin; nuna bi sofo ra Cortés nuni Coyoacan, nu'u̱ to'o mi pädi yoho ya hñäki ngu'a ra jerónimo aguilar ra malintzin."	"Ra Cuauhtémoc, Tlacotzin, ra Cihuacóatl, Oquiztzin, Panitzin, Motelhuihtzin; nuna bi sofo ra Cortés nuni Coyoacán, nu'u̱ to'o mi pädi yoho ya hñäki ngu'a ra Jerónimo Aguilar ra Malintzin."
t'ena ge ya macehual [ya jä'i b'u̱i ha ra hyoya]	t'ena ge ya masehual [ya xä'i bʼui ha ra xoyoa]
"xki thokuabi nuya hotho ts'ints'u̱ mra thuhu ra ""tlauhquecho"" ne “tzinitzcan zacuan"","	"Xki thokabi nuya hoto hots'ints'u mra thuhi ra ""tlauhkecho"" ne “tsinitstsani zakuani”,"
-¿te be'a gi mä nu'i Cihuacóatl?	-¿te be'a gi mä nü'i Cihuacóatl?
"bi k'ahni ko ya dänga ñuni nzafi ne bi thetse ko ya makahuai nuya otomi geb'u̱ bi japi bi b'e̱di, bi mä nuyu̱:"	"Bi k'ahni ko ya däŋga ñuni nzafi ne bi thetse ko ya makahuai nuya otomi geb'u bi japi bi b'edi, bi mä nuyu."
da thuts'i ya njot'ihñä ( )	Da thuts'i ya ñjot'ihñä
"da umbabihe te da zi, da japabihe ndunthi ma zu."	"Da ūmbabihe te da zī, da jababihe ndūnthi ma zū."
ebu̱ bi mä nuna b'e̱fi xa thoki xahño bi johya ra ts'e̱y'e̱hmu.	Ebu̱ bi mä nuna b'e̱fi xa thoki xahño bi johya ra ts'eehmu.
"fernando alva ixtlilxóchitl, xiii njändahmä ""ra ñ'ehe ya ñämfo̱ ne ra mu̱di ra hoga ts'ofo ra evangelio."""	"Fernando Alva Ixtlilxóchitl, XIII njändahmä ""ra ñ'ehe ya ñämfo ra nu̱di ra hoga ts'ofo ra Evangelio."""
"ga juatihu̱ nu'a huts'i njani, ya ts'ojä'i, ra carranza, ge xa o̱t'a ya ts'okuate pa gekagihu̱; ga o̱t'e da nja ra ts'e̱di ma munts' ne njabu̱ ga tsu̱dihu̱ da nja nu'a ra hoga tsu̱tui, da nja ra hai, ra hñegi ne ra hoga ts'u̱tui;"	"Ga yuatihu ñ'a huts'i ñani, ya ts'ojä'i, ra Carranza, ge xa ñot'a ya ts'okuate pa gekagihu; ga ñot'e da ña ra ts'edi ma munts' ne ñabu ga tsudihu da ña ñ'a ra hoga ts'utui, da ña ra hai, ra hñegi ne ra hoga ts'utui;"
gatho ya hyoyajä'i mi b'u̱i ha ra hnini bi handi.	Gatho ya hyoyajä'i mi b'üi ha ra hnini bi handi.
"ha bi häni ra ñ'udi, ma jä'ihu̱ bi ent'i gatho mahye̱gi nuya nzu̱te"	"Ha bi hani ra ñudi, ma jaihu bi ent'i gato mahyegi nuya nzute"
"ha n'aa nza̱tho xudi ra pale berto, bi bo̱ni nda hyonga te nda nzimxidi ngetho nda zi ya hme hyaxtho mi u̱xa ya u, ua ngu mi nzäi mi nkahui yá hme nuya txuju̱ xa hogi ha nuya 'bomuha̱i nts'ät'i, nt'o̱kuä;"	"Ha na'a nzātho xudi ra Pale Berto, bi bōni nda hyōnga te nda nzīmxidi ngetho nda zī ya hme hyāxtho mī ūxa ya ū, ūa ngu mī nzäi mī nkahui yá hme nūya txūjū xa hōgi ha nūya 'bōmūhāi nts'ät'ī, nt'ōkūä;"
"ha nubia di ndäki, di ndändiñähmu, di ma ga ts'u̱tsa'i ri y'e, ga ndäne'i ra nge'a nu'a'i ma makjahe, ra bartolomé lópez, nub'u̱ mi njuäni ma b'e̱hña inbi njuäni ha nubu̱ mi xaxi pa da o̱t'a ya tso̱mfen"	"Ha nubia di ndäki, di ndändiñähmu, di ma ga ts'u̱tsa'i ri y'e, ga ndäne'i ra nge'a nu'a'i ma makjahé, ra Bartolomé López, nub'u̱ mi njua̱ni ma b'e̱hña inbi njua̱ni ha nubú mi xaxi pa da o̱t'a ya tso̱mfe̱n"
"ha ya t'u̱ka ze̱ki thuts'i n'a tu̱kitho nuna thogi ge bi huxa ra fernando alva ixtlilxóchitl, nu'a b'e̱tsi ra xiiii njondahmä."	"Ha ya t'uka zeki thuts'i n'a tukitho nuna thogi ge bi huxa ra Fernando Alva Ixtlilxóchitl, nu'a bets'i ra XIV njonda hmä."
habu̱ ga ju̱he nuyu̱ (ya tenochcas) te gi honihu̱?	Habų ga jųhe nųyų (ya Tenochcas) te gi hŏnių?
"ham'u̱ gatho ya juän'ahmä ge nuua xa ze̱ti ri ñ'ehe dige'a ya noya ya mu̱dimehai ha ra hñä ya ndeznä, nuna thuhu ri uni inga se̱he̱ ra n'atsanoya pa da fädi ra hñämfo̱, ingi ri me̱udi dige'a ra hmä fu̱oti dige'a nuna ra hñäki ra netzahualcoyotl. ne ra cuauhtémoc."	"Hamu̱ gatho ya Juán'ahmä ge nuua xa zeti ri ñ'ehe dige'a ya noya ya mudimehai ha ra hñä ya ndeznä, nuna thuhu ri uni inga sehë ra n'atsanoya pa da fädi ra hñämfo̱, ingi ri me̱udi dige'a ra hmä fu̱oti dige'a nuna ra hñäki ra Netzahualcoyotl. Ne ra Cuauhtémoc."
mi hneki ngu ma jä'ihu̱ ngabu̱ mri hneki.	Mi hneki ngu ma jaihu ngabu mri hneki.
"ndunthi bri johya, bri thuxpabi gatho nu'a mi o̱t'abi ra b'edi, ko nge'u̱ bi m'u̱i ne mi t'umbabi ya t'ixu:"	"Ndũñthi bri johya, bri thuxpabi gatho nu'a mi o̱t'abi ra b'edi, ko nge'u̱ bi m'u̱i ne mi t'ũmbabi ya t'ĩxu:"
"ngu mra me̱ti, nu'a r'a hyodi, habu mi y'o, n'a ngu n'a mi johya mi mfe̱m'a xinxi xi mi johya ya ndäte, mi thede n'a ngu n'a mi hñu̱fi ne mi fe̱m'a ya xinxi: xi mi b'u̱i mpaha."	"Ngu mra mehti, nu'a r'a hyodi, habu mi y'o, n'a ngu n'a mi johya mi mfema xinxi xi mi johya ya ndate, mi thede n'a ngu n'a mi hnuifi ne mi fema ya xinxi: xi mi bui mpaha."
"njabu̱ ri ñ'ehe ya je̱ya inda m'e̱di, inda mpumfri, ga nzäi ga pe̱tsi nugagihu̱ ha ma mfenihu̱, ga pe̱tsi nugagihu̱, ra bätsi dige'u̱, ya b'e̱to, ya ntsaniku, ya mbänga b'e̱to ne to'o dra ñ'epu̱, to'o mahye̱gigihu̱, ma jihu̱, ya ku̱hu̱."	"Njäbu ri ñ'ehe ya jëya inda m'ëdi, inda mpumfri, ga nzäi ga pëtsi nugagïhu ha ma mfenïhu, ga pëtsi nugagïhu, ra bätsi digë'u, ya b'ëto, ya ntsanïku, ya mbänga b'ëto ne to'o dra ñ'ëpu, to'o mahyëgïgïhu, ma jïhu, ya kuhu."
"nu xä oth'u̱, ma gä ñ'jähu̱"	"Nü xä oth'u, ma gä ñ'jähu"
"nuga̱ xi di ne'i, hindi pädi hanja..."	"Nuga̱ xi di ne'i, hindii pädi hanyá..."
"num'u̱ di johyahu̱, nkuehu̱, nts'o̱mihu̱, tsuhu ne pa da t'o̱xkähu̱ di hohñu̱ nu ya nt'u̱i xi di 'yoohu̱ (¡!). nuya da nt'ot'i ko ra dänt'ot'í"	"Numʉ̱ di joyahʉ̱, nkʉ̱ʉ̱, nts'omʉ̱, tsʉ̱ ne pa da t'oxkähʉ̱ di hohñʉ̱ nu ya nt'ʉ̱i xi di 'yohʉ̱ (!). Nʉ̱ya da nt'ot'i ko ra dänt'ot'í"
"nuna bi johya ha ra mabagi,"	"Nuna bi johya ha ra mbaghi,"
"nuya hñu o gohoya pa bi b'u̱i nubu̱ bi xitsuabi ra jäpadehe ndunthi ya jä'i, ngu xa t'ena."	"Nuya hñu o gohoya pa bi b'ui nubu bi xitsua'bi ra jäpadehe ndunthi ya jä'i, ngu xa t'ena."
"nuya tsat'io mi b'et'o, mi gu̱t'a ra ñ'u, mi teni, ya xiñu mi ju̱ts'i pa mañä, xi mi pähä gatho mi handi mi nest'ihi: mi tu̱ta ya jihni"	"Nuya tsati'o mi bet'o, mi gut'a ra ñ'u, mi teni, ya xinu mi juts'i pa maña, xi mi paha gato mi handi mi nestihi: mi tuta ya jihni"
"pe, nu'i ndada nu'i ma t'ek'ei ra makja, nub'u̱ nu'i ingi zugagihe, ¿hanja, nuua, ra hyo di ge'a, ga tsogi nubu̱ [nu'a ma b'e̱hña]?"	"Pe, nu'i ndada nu'i ma t'ek'ei ra makja, nub'u nu'i ingi zugagihe, ¿hanja, nuua, ra hyo di ge'a, ga tsogi nubu nu'a ma b'e̱hña?"
"r'a ya jä'i mi b'u̱i ha ra ngumi ja nunu ha ra hnini ri manjuäntho pa da tsoni nubu̱ ra amáxac,"	"R'a ya jä'i mi b'ui ha ra ngumi ja nunu ha ra hnini ri manjuäntho pa da tsoni nubu ra amáxac,"
"ra nge'a di o̱t'a nuna noya ra ts'u̱tui ne gatho to'o da guat'a ha ma hyohe, nu'u̱ to'o da ne, da me̱tsi n'a ra hoga m'u̱i ne da m'u̱i manjuänthä. ha nubu̱ xa mabu̱ ma noya ge di pe̱tsi ra tsa, dega hoga jä'i ne dega hogat'o̱t'antuhni"	"Ra ngë'a di o̱t'a nuna noya ra ts'ü̱tui ne gatho to'o da guat'a ha ma hyohe, nu'u̱ to'o da ne, da me̱tsi n'a ra hoga m'ü̱i ne da m'ü̱i manjüänthä. Ha nubü̱ xa mabü̱ ma noya ge di pe̱tsi ra tsa, dega hoga jä'i ne dega hogat'o̱t'antü̱ni"
ra ngehna nuna pa bi ma n'a ra ñ'u manjuäntho.	Ra ngëhna nuna pa bi ma n'a ra ñ'u manjuänto.
"ra nhñu ne ra ngästsi ra b'ist'ofo di huts'ihu̱ ha nuna ze̱ki b'ist'ofo, ri ñ'ehe ra vii njondahmä ra chimalpain,"	"Ra nhñu ne ra ngätsi ra b'ist'ofi di huts'ihu ha nuna zeki b'ist'ofi, ri ñ'ehe ra vii njonda'hma ra tsimalpahi,"
"ra nthädi ra cuitlahuacatzin bi ena ge ina da o̱t'e nuya bi b'e̱pabi ya nso̱ho̱jä'i,"	"Ra ntʰädi ra kuitlaxochitzin bi ʔena ge ina da o̱tʔe nuʔya bi bʔepabi ya nsʔoho̱jäʔi,"
"ra nyoho nu'a mi zu ra tepoztlan; ra nhñu ra me tizatlan, ra njoho mi ñ'ehe nuni huehuetlan ne ra nku̱ta mra dänga mictlan."	"Ra nyoho nu'a mi tsu ra Tepoztlán; ra njnu ra me Tizatlán, ra njoho mi ñ'ehe nuni Huehuetlán ne ra nkuta mra däŋga Mictlán."
ri ñ'udi xahño nubia hanja beni ya metlaxcala bi do̱m'i mpaha nuya nso̱ho̱ jä'i.	Ri ñ'üdi xahño nubia hanja beni ya Metlaxcala bi dõm'i mpaha nuya nsõhõ jä'i.
"t'ena ge inbi unga mfädi pa gatho ya jä'i mi ñ'oui, ge nuna ndada ra marqués da ñ'ehe dra hmu ha ma haihe, da ja me̱ti nu'a di pe̱tsihe nehe dra jakagihe ga mpe̱fihe ra hai ge bi umbabi o bi hänbabi ya hoga hai ya n'añ'o hnini."	"T'ena ge inbi unga mfädi pa gatho ya jä'i mi ñ'oui, ge nuna ndada ra marqués da ñ'ehe dra hmu ha ma haihe, da ja me̱ti nu'a di pe̱tsihe nehe dra jakagihe ga mpe̱fihe ra hai ge bi umbabi o bi hänbabi ya hoga hai ya n'añ'o hnini."
"xi mi taxki ra ñ'u, imbi tsa da r'anga n'a, ho̱nse̱he̱ mi taxka n'a ha ra bo̱hai. ya y'ofadi mi ju̱t'atho."	"Xi mi taxki ra ǹ'u, imbi tsa da r'anga n'a, ho̱nse̱he̱ mi taxka n'a ha ra bo̱hai. Ya y'ofadi mi ju̱t'atho."
"ya dänga mfu̱nga bo̱jä bi ntho, bi kot'i ko ya mahjuai, mi zu̱m'i nehe ko ya t'e̱nga ts'u̱t'abo̱ja."	"Ya däŋga mfu̱ŋga bojä bi n̄tho, bi koti ko ya mahjuaí, mi zum'i nehe ko ya t'ëŋga ts'ut'aboja."
ya r'atsanoya ra sahagún mi mä hanja mi yopa tsini. ya ndeznä bi nkohi inda ñ'udi. mi hatatho pa bi mu̱di ra ntuhni	Ya r'atsanoya ra Sahagún mi mä hanja mi yopa tsini. Ya ndeznä bi nkohi inda ñ'udi. Mi hatatho pa bi mu̱di ra nt'u̱hni
"ya zi b'e̱hña mi ägi ha ya b'a ne ha ya ngo̱de, nuya ñ'o̱ho̱ mbo ha ya ne, ha ya njom'ahudi."	"Ya zi be̱hña mi ägi ha ya ba ne ha ya ngo̱de, nuya ñ'o̱ho̱ mbo ha ya ne, ha ya njomahudi"
"bi boxro xi 'be̱ts'ina, bido'u̱ ro 'yu̱ni 'na, xi bi bo̱x ro hjua 'na, bido'u̱ ro ts'ii 'na, xi bo̱xro ts'äre 'na. ge'bu̱ go min pu̱n doja 'na."	"Bi boxro xi be̱ts'ina, bido'u ro yuni na, xi bi boxro ro hua na, bido'u ro ts'ii na, xi boxro ts'are na. Gebru go min pun doja na."
bi ma manjuäntho habu̱ mi b'u̱i ra ts'e̱y'e̱hmu bi xipabi;	Bi ma manju̱antho habu̱ mi b'ui ra tse̱y'e̱hmu bi xipabi;
bri juahni po nuya dra hmu.	Bri juahni po nuya drahmu.
"di to̱m'ihe ra ñ'ethi pa nugagihe, n'a ra pa ngu ma n'a ra pa thogi nekagihe di huadihe ra nge'a indi tse̱tihe nuna b'u̱i t'o̱t'e ko ngekagihe man'año ya ntho, t'e̱nts'igihe thi ma haihe ma me̱tihe, ju̱kagihe ga mpe̱fihe ndunthi, b'e̱kagihe ga jut'ihe xdunthi ya boja, n'a ngu n'a ra pa nuna njut'i di o̱t'ehe man'a te ma thaihe di tuhe."	"Di tom'ihe ra ñ'ethi pa nugagihe, n'a ra pa ngu ma n'a ra pa thogi nekagihe di huadihe ra nge'a indi tsetihe nuna b'ui t'ote ko ngekagihe man'ano ya ntho, t'ents'igihe thi ma haihe ma metihe, jukagihe ga mpefihe ndunthi, bekagihe ga jut'ihe xdunthi ya boja, n'a ngu n'a ra pa nuna njut'i di otehe man'a te ma thaihe di tuhe."
gatho nuna hai ha nuna r'ayo ximhai njabu̱ bi thutuabi nuya nso̱ho̱jä'i inbi tsa bi thutuabi man'a ra thuhu.	Gatho nuna hai ha nuna r'ayo ximhai ñabü bi thutuabi nuya nsö'höjä'i inbi tsa bi thutuabi man'a ra thuhu.
"ha mi tso nde, bi mu̱di bi nja n'a ra hneki ngu njagihu̱ dega jä'i, bi t'ot'e ra b'ai ngu dega jä'i,"	"Ha mí tso nde, bi mūdi bi njá n'a ra hneki ngu njagīhu dega jä'i, bi t'ot'e ra b'ai ngu dega jä'i,"
"ma bo̱nahmu'ihe: nuna b'e̱fi ga tsokagihe sta juatihe gatho: gi nuti nuua, xa hño bo̱nahmu."	"Ma bõnahmu'ihe: nuna b'ëfi ga tsokagihe sta juatihe gatho: gi nute nu'ua, xa hño bõnahmu."
"mi mä dega ts'e̱dira hñä tso̱pu da ts'o̱ho̱bu nuya nzo̱ho̱jä'i ga handihu̱ te ma ts'e̱di pe̱tsi, ra nge'a ma ajuä ra quetzalcohuatl b'u̱i nuua ko ngekagihu̱,"	"Mi mä dega ts'edirá hñä tsópu da ts'oho̱bu nuya nzoho̱jä'i ga handíhu̱ te ma ts'edi pe̱tsi, ra nge'a ma ajuä ra ketsalcoatl b'ui nuua ko ngekagíhu̱,"
"ne ya nt'u̱i, hanja di thuts'i ya nt'ofo, njap'u̱ nehe mä 'ra ya mpeu̱i da fats'i di nt'ot'i ra hñähñu"	"Ne ya nt'üi, hanja di t'uts'i ya nt'ofi, njap'ü nehe mä 'ra ya mpeüi da fats'i di nt'ot'i ra hñähñü"
"nub'u̱ nu'i ingi japi da bo̱nga nu'a ra makja ha nu'a ra hnini, ¿hanja ra yotui, ga tso̱gi nubu̱ ma b'e̱hña? o̱t'a r'ato ya je̱ya bi mu̱di [ra makja ra bartolomé lópez]"	"Nub'u̱ nu'i ingi japi da bo̱nga nu'a ra makja ha nu'a ra hnini, ¿hanja ra yotui, ga tso̱gi nubu̱ ma be̱hña? O̱t'a r'ato ya je̱ya bi mu̱di [ra makja ra Bartolomé López]"
pa ga b'u̱i mpaha ne ga o̱t'e n'a ra njondahmä gatho nu'a ga handi.	Pa ga bʉi mpaha ne ga ʔtʔe nʔa ra ñondoʔmä gato nuʔa ga jandi.
"r'a nuna mi nthandi ngu nu'a ma thänjuahu̱ (ychtlilmatli), xi mra nts'o, mi kuet'e ha ya ngo̱,"	"Ra nuna mi nthandi ngu nu'a ma thänjahu (yechtlilmatli), xi mra nts'o, mi kuet'e ha ya ngo."
"xa zägi mpaha, nub'u̱ xa njabu̱ xa japabi ma zu ne inte xa t'o̱tuabi nub'u̱ inda japi xa po̱ho̱ bi ya kue̱ ra nge'a ya jä'i xi mra no̱t'e ne mra hyotejä'i,"	"Xa zägi mpaha, nub'u xa njabu xa japabi ma zu ne inte xa t'otabi nub'u inda japi xa poxo bi ya kue ra nge'a ya jä'i xi mra no'te ne mra hyotejä'i"
"y'o, ri ma ne gi xipabihu̱ ya metlaxcala ge ma r'a ya me̱ti jä'i ne ri ajuähu̱, ge nu'a ga mä ge xa ehe nuua ma haihu̱, ge di umbabihe ma nthädihe."	"Yʉ, ri ma ne gi ʃipabiʰu ya Metlaxcala ge ma rʔa ya meʔti ʒäʔi ne ri axuäʰu, ge nuʔa ga mä ge ʃa eʰe nuua ma ʰaiʰu, ge di umbabiʰe ma nʔädiʰe."
¿te da o̱t'e ma jä'ihu̱ sta b'e̱dihu̱?	¿te da ote ma jaihu sta beidu?
"-da ts'iua:... ri ñ'ehe ge'a ma njueih'u̱. da o̱t'ehe ya ñ'o̱te ko ya he̱m'i, ya ñ'o̱t'ehe ko ya ntuts'i. da o̱ts'e̱ ra b'e̱na noya."	"Da ts'iuá... ri ñ'ehe ge'a ma ñyuēiʔu. Da oʔt'ehe ya ñ'oʔte ko ya hem'i, ya ñ'oʔt'ehe ko ya ntuts'i. Da oʔts'ē ra b'ēna noya."
-dom'i ma ajuähu̱ ge inda yu̱t'a ha ma nguhu̱ nuhu̱ to'o e̱nts'i pa thi ne da hokuabi ra honanhyo nub'u̱ sta ne da hyoki ya inda za.	Domi ma ajüähu ge inda yüt'a ha ma nugu nuhu to'o eñ'tsi pa thi ne da hoküabi ra honanhyo nub'u sta ne da hyoki ya inda za.
"-o̱t'a ra mäte gi o̱dehu̱, ja gi b'ai nuuahu̱. mont'a ya ngo ajuä; ri juat'i ra ngo ga tsunda ma ajuähe."	"-ota ra mate gi odehu, ja gi b'ai nuahu. mont'a ya ngo ajua; ri juati ra ngo ga tsunda ma ajuahe."
"-xa hño, di b'u̱ihe njamädihe."	"Ŋa hño, di bʼuihe ñamädihe."
-¿nguande njabu̱ ga mäu gra juähu̱?	-¿Ngwande njabu̱ ga mä'u gra juähu̱?
"-ñ'emabagi, ya gabida, ya jä'ihu̱ gi pädi ra ntuni ra mem'onda ba ehehu̱ ga te̱nihu̱ma nzu̱tehu̱. ko ya mätsa mi te̱he̱, ko ya bu̱'bai ko ngatho ra ts'e̱di mi te̱he̱ ra ñ'u."	"Ñemabagi, ya gabida, ya jahi̱hu̱ gi padi ra ntuni ra mem'onda ba ehehu̱ ga teni̱hu̱ma nzute̱hu̱. Ko ya ma̱tsa mi te̱he̱, ko ya bu̱'bai ko ngato ra tse̱di mi te̱he̱ ra ñ'u."
"bi tse̱ti nuna ngot'i ra m'onda, ngu pede ra dänga b'ede, ya k'oi ne ya njändahmä, ngu nu'a ra hmä ra alonso axayaca, goho n'ate ma pa bi nzo̱t'e nuna pa."	"Bi tse̱ti nuna ngot'i ra m'onda, ngu pede ra däŋga b'ede, ya k'oi ne ya njä̱ndahmä, ngu nu'a ra hmä ra Alonso Axayaca, goho n'ate ma pa bi nzō̱t'e nuna pa."
"into y'o manjuäntho, into pa ri nektho."	"Intō yʼo manjwäntō, intō pa ri nekhtō."
"nub'u̱ ndi umbabihe ma njut'ihe xki nzäi ndi da'ihe, mi adi n'a tu̱ki nehe nub'u̱ ndi unihe ya k'astaboja mi häni made n'a tu̱ki [...]"	"Nub'u̱ ndi umbabihe ma njut'ihe xki nzäi ndi da'ihe, mi adi n'a tu̱ki nehe nub'u̱ ndi unihe ya k'astaboja mi ha̱ni made n'a tu̱ki [...]"
"ya miñ'o ko ngehna hmä ri johya,"	"ya miŋ'o ko ŋehna hmä ri johya,"
bi tso̱hso̱ ra ngo ma ajuähu̱: nubia da fu̱di da guadi ra r'e̱t'a ra pa.	Bi tsohso ra ngo ma ajüähü: Nubia da füdi da gwadi ra r'et'a ra pa.