Input	Result
"-pasadores: ""ya nts'äza xi mra nts'u̱t'i mi t'e̱ni ko n'a ra t'e̱nga ts'u̱t'a bo̱ja mi thutuabi ra ballesta""."	ya ntzaʼa ɨi mra ntɨʼtɨʼ mi tʼeɨni ko nʼa ra tʼeɨnga tɨʼtɨʼa boɨja mi tʼutuabi ra ballesta
"cantares mexicanos, biblioteca nacional de méxico, ya nt'ofo 1628 bis, folio 16 v."	"Cantares mexicanos, biblioteca nacional de México, ya nt'oho 1628 bis, folio 16 v."
"ebu̱ bi bo̱ni, bi meui nuni nonohualco, ha ra ngu ra b'ongui habu̱ ra gabida ne ra malintzin ne ""ra hyadi"" (alvarado) ne ra sandoval."	"Ebu̱ bi bo̱ni, bi meui nuni nonohualco, ha ra ngu ra b'ongui habu̱ ra gabida ne ra malintzin ne ""ra hyadi"" (Alvarado) ne ra Sandoval."
gi handi ra nt'ofo ra thuhu ra crónicas de la conquista	gi jandi ra nd'ofo ra t'uhu ra crónicas de la conquista
"guzmán. ha ya he̱m'i b'e̱tsa je̱ya manteb'u̱ di ge nuua m'onda ne ya hyo, nu'a ra hmä ra 12-conejo (1530) ge xa hmä ge xibú bi yut'i ha ra culhuacan ya ndeznä, nda pablo xochiquetzin, motelchiuhtzin ne ra guzman."	"Guzmán. Ha ya hem'i be̱tsa je̱ya mante̱b'u di ge nuua m'onda ne ya hyo, nu'a ra hmä ra 12-conejo (1530) ge xa hmä ge xibú bi yut'i ha ra culhuacan ya ndeznä, nda Pablo Xochiquetzin, Motelchiuhtzin ne ra Guzmán."
"ha ga ñ'udihu̱ ra nt'ofo ya ñämfo̱ po ra nthuts'i ra doctor garibay,"	"Ha ga ñ'uðiu ra nt'ofu ya ñämfu po ra nthuts'i ra doctor Garibay,"
ha nu'a hyodi nubia thutuabi ra san martin.	Ha nu'a jyodi nubia thutuabi ra San Martín.
"he̱mi unga mfädi ha ra t'u̱ka hnini habu̱ b'u̱i ya jä'i teni ra división ra arenas, 27 ra abril ra je̱ya 1918, ra m'ets'a he̱m'i ra zapata, b'e̱tsi ha ra universidad nacional autónoma de méxico, expediente 29."	"Hëmi unga mfädi ha ra t'uka hnini habu b'ui ya jä'i teni ra división ra arenas, 27 ra abril ra jëya 1918, ra m'ets'a hëm'i ra zapata, b'ëtsi ha ra Universidad Nacional Autónoma de México, expediente 29."
"m'e̱fa ha ra hñuti bri thätuabi na ra hñe xki tagiri mo̱te, nehe bri jom'a ra xu̱tha ko n'a ra t'axa dutu mra thuhuu ra ""campanillante""."	"m'efa ha ra hñuti bri thätuabi na ra hñe xki tagiri mo̱te, nehe bri jom'a ra xu̱tha ko n'a ra t'axa dutu mra thuhuu ra ""campanillante"""
"ma dada'ihe gra ts'u̱tui, di ne gi pädi ge ma me̱t'o instä thogihe nuna thogi gatho ya mapa xki r'ani, bi juat'i ko ngeke nu̱'u ri b'e̱go, ri me̱fi ya ñämfo̱, ra nge'a majuäni ra hernando cortés ra ndä gabida,"	"Ma dada'ihe gra ts'utui, di ne gi pädi ge ma met'o insta thogihe nuna thogi gatho ya mapa xki r'ani, bi juat'i ko ngeke nu'u ri b'ego, ri mefi ya ñamfo, ra nge'a majuani ra Hernando Cortés ra nda gabida,"
mi b'u̱i ya mu̱dimehai mi ñä ra ndeznä ne habu̱ ra hnini dige'a gatho ra nxiki m'onda ngu r'a ya yaqui b'u̱i nuni sonora ne ya maya ri ñ'ehe nuni yucatán ra nge bi guat'i ha ra tuhni bi nja nuua m'onda fädi ko ra thuhu ra revolución mexicana ya je̱ya 1910-1919.	mi bʉi ya mudimejai mi ñä ra ndeznä ne habʉ ra hni ni dige'a gatho ra nxiki m'onda ngu r'a ya yaqui bʉi nuni sonora ne ya maya ri ñ'ehi nuni yucatán ra nge bi guat'i ha ra tuhni bi nja nuua m'onda fädi ko ra thuhu ra revolución mexicana ya jeyai 1910-1919.
mi fo̱tuabi ya ts'u̱tnibo̱ja mi thutuabi ya hñämfo̱ ra pasadores nehe ya bo̱zna ko ya nzafi.	mi fōtūābi ya ts'ūtñibo̱ja mi thutuabi ya ñǵāmfo̱ ra pasadores nehe ya bōzna ko ya nzāfi
"n'a nt'udi di ge'a nuya nthoki bri t'o̱t'e ha ya hñä ya ndeznä ra ngätsi ra nthebe nje̱ya ra r'e̱t'a ma gu̱to (s. xix), r'a ya hnini ngu ra xicontepec (villa juárez) nuna hyodi kohi nuni puebla."	"N'a nt'udi di ge'a nuya nthoki bri t'o̱t'e ha ya hñä ya ndeznä ra ngätsi ra nthebe nje̱ya ra r'e̱t'a ma gu̱to (s. xix), r'a ya hnini ngu ra xicontepec (Villa Juárez) nuna hyodi kohi nuni Puebla."
"n'a ra t'axa dutu mi pe̱tsi ya k'oi ra ixki, nuna mra thuhu hñämfo̱ ""campaneante resonador""."	"n'a ra t'axa dutu mi pe̱tsi ya k'oi ra ixki, nuna mra thuhu hñämfo̱ ""campanente resonador""."
"ne ri mpe̱fi ha ra dängan gu nt'udi ra thuhu ra facultad de estudios superiores, acatlán, unam,"	"Ne ri mpʉ̱fi ha ra däŋan gu nt'udi ra tʉhu ra Facultad de Estudios Superiores, Acatlán, UNAM,"
"nthandi gatho nu'a ra munts'i ra thuhu hñämfo̱ ra globalización ge 'a po̱ts'e dega nest'ihi, nuna y'o̱te to̱m'i da nja ra ntho̱mäte."	"Nthandi gatho nu'a ra munts'i ra thuhu hñämfo ra globalización ge 'a po̱ts'e dega nest'ihi, nuna y'o̱te to̱m'i da nja ra ntho̱mäte."
"nu'a ma r'a ya jä'i mi pädi nuña b'e̱fi bri b'e̱pabi xa hyoki yoho ya mpe̱fi mi fädi ko ra thuhu ra amosqueador ko ya xi ya ts'ints'u̱ xi sta hotho, gi hutsuabi made dige'a n'a ra zänä dega k'astaboja"	"Nü'a ma r'a ya jä'i mi pädi nüña bëfi bri bëpabi xa hyoki yoho ya mpëfi mi fädi ko ra tühu ra amosqueador ko ya xi ya ts'ints'u xi sta hoto, gi hutsuabi made dige'a n'a ra zänä dega k'astaboja"
"nu'a ra munts'a jä'i bi te̱ni bi zipabi man'a ya b'ede, mi t'ena ge ya jä'i xki b'u̱i nubu̱ inbi pe̱tsi ra ts'e̱di nu'a mi mä pe m'e̱fa bi japi bi nxaxni ya tsu̱tui ne n'a ra diputado mi pe̱tsi ra mfeni xki kot'i mra thuhu ra josé maría lozano, bi y'onga ra hmä pa mar'a ya ñ'oui bi nxanxi: ""ri mo̱te ra thits'i mi udi ra emiliano zapata, nehe bri fädi ngu ra atila nuna bri nju̱tsi [...] nu'a bi fädi ngu mi he̱gi ya b'e̱go ne'a bi mä da uni da nja pa gatho, ingi jot'i [...]"	"Nü'a ra munts'a jä'i bi te̱ni bi zipabi man'a ya b'ede, mi t'ena ge ya jä'i xki b'u̱i nubü inbi pe̱tsi ra ts'e̱di nü'a mi mä pe m'e̱fa bi japi bi nxaxni ya tsü̱tui ne n'a ra diputado mi pe̱i ra mfeni xki kot'i mra thuhu ra José María Lozano, bi y'onga ra hmä pa mar'a ya ñ'oui bi nxanxi: ""Ri mo̱te ra thits'i mi udi ra Emiliano Zapata, nehe bri fädi ngu ra Atila nuna bri njü̱tsi [...] nü'a bi fädi ngu mi he̱gi ya b'e̱go ne'a bi mä da uni da nja pa gatho, ingi jot'i [...]"
nu'u̱ to'o ñä ra ndenzä ha r'e̱t'a ma r'at'o ya estados.	nu'u̱ to'o ñä ra ndenzä ha r'e̱t'a ma r'at'o ya Estados.
"nub'u̱ ri m'e̱hni ne ri b'e̱go ya ñämfo̱ bi juat'i ko ngekagihe ne bi tso̱ho̱ ra gabida ra thuhu ra hernán cortés, maske indi pädihe ge gatho da za da o̱t'e ne xi ra nzunda maría trinidad,"	"Nub'u̱ ri me̱hni ne ri be̱go ya ña̱mfo̱ bi juat'i ko ngekagihe ne bi tso̱ho̱ ra gabida ra thuhu ra Hernán Cortés, maske indi pa̱dihe ge gatho da za da o̱t'e ne xi ra nzunda María Trinidad,"
"nubia, unga mfädi ha ra ñähñu jamädi ra universidad autónoma del estado de hidalgo."	"Nubia, unga mfädi ha ra ñähñu jamädi ra Universidad Autónoma del Estado de Hidalgo."
"nugi, ra miguel hernández ge di pe̱tsi ma ngu nuni chiyauhtzinco, ko ra t'ek'ei di udi ko nge'i, nuna m'e̱hnant'ofo di hoki go tso̱n'i ko nge'i, ma t'ek'ei bo̱nahmu'i nda doctor alonso ruiz, ra nk'ohnate ge gi b'ui nuua ha ra hnini ra quamochtitla."	"Nugi, ra Miguel Hernández ge di pe̱tsi ma ngu nuni Chiyauhtzinco, ko ra t'ek'ei di udi ko nge'i, nuna m'ehnantofo di hoki go tso̱ni ko nge'i, ma t'ek'ei bo̱nahmu'i nda doctor Alonso Ruiz, ra nk'ohnate ge gi b'ui nuua ha ra hnini ra Quamochtitla."
"nuna he̱m'i bri t'unga mfädi ko ra t'u̱ka nthint'ant'ofo po ra marcelo díaz salas ne ra luis reyes garcía ha: tialtocan, revista de fuentes para el conocimiento de las culturas indígenas de méxico, vol. vi, 1970, b'ede ra 3, pp. 193-212."	"Nuna hem'i bri t'unga mfädi ko ra t'u̱ka nthint'ant'ofo po ra Marcelo Díaz Salas ne ra Luis Reyes García ha: Tialtocan, Revista de Fuentes para el Conocimiento de las Culturas Indígenas de México, Vol. VI, 1970, b'ede ra 3, pp. 193-212."
"nuna hñäpi huts'i ha n'a ra he̱m'i fädi ra derecho canonigo ko ra thuhu hñämfo̱ ngu ra ""solicitación al administrar el sacramento de la confesión""."	"Nuna hñäpi huts'i ha n'a ra he̱m'i fädi ra derecho canonigo ko ra thuhu hñämfo̱ ngu ra ""solicitación al administrar el sacramento de la confesión""."
"nuna m'e̱hna nt'ofo b'e̱tsi ha ra archivo histórico nacional, madrid, documento 165. bi unga mfädi ha ra nt'ofo ya zubi po ra y'ofo ra thuhu ra arthur j. o. anderson et al.: byond the codices: the nahua view of colonial mexico, berkeley, university of california press, 1976, pp. 181-187."	"Nuna m'ehna nt'ofö b'etsi ha ra Archivo Histórico Nacional, Madrid, documento 165. Bi unga mfädi ha ra nt'ofö ya zubi po ra y'ofö ra thuhu ra Arthur J. O. Anderson et al.: Beyond the Codices: The Nahua View of Colonial Mexico, Berkeley, University of California Press, 1976, pp. 181-187."
"nuna nt'ofo b'e̱tsi ha ra archivo general de indias, sevilla, audiencia de méxico 168, bi unga dra fädi po ra miguel león-portilla ha cultura en peligro, méxico, alianza editorial mexicana, 1976, pp. 102-103."	"Nuna nt'oho b'e̱tsi ha ra Archivo General de Indias, Sevilla, Audiencia de México 168, bi unga dra fädi po ra Miguel León-Portilla ha Cultura en Peligro, México, Alianza Editorial Mexicana, 1976, pp. 102-103."
"nuna pika he̱m'i ja te mä b'e̱tsi ha ra archivo general de la nación, nuua m'onda ne ja ha ra ndunthi ya hnini, njabu̱ ngu ya nzaya nuni manhyati ne mar'a ya hnini, o̱t'e gi o̱de ra hñä ra mu̱dimehai."	"Nuna pika hem'i ja te ma be̱tsi ha ra Archivo General de la Nación, nuua monda ne ja ha ra ndunthi ya hni̱ni, njabu̱ ngu ya nzaya nuni manhyati ne mar'a ya hni̱ni, o̱te gi o̱de ra hñä ra mu̱dimehai."
"nuua t'unga yoho ya hmä, kuän'ahmä ya ndeznä ne thuts'i ha n'a ra k'oi mä mäjuäni ri nthe̱ui n'a ya dänga ra thu̱ahmä manteb'u̱, nuua pede nu'a gatho ya ts'othogi bi y'o̱t'a dega fete ra alvarado."	"Nüüa t'unga yoho ya hmä, kwän'hmä ya ndeznä ne tuts'i ha n'a ra k'oi mä mäjuäni ri nthe̱üi n'a ya dänga ra thu̱hmä manteb'ü, nüüa pede nü'a gatho ya ts'otogi bi y'ö̱ta dega fete ra Alvarado."
"nuua ya mu̱di noya ra motolinia, ha ra mu̱di nkohi bi t'o̱t'e ko ra thuhu ra tratado tercero ra dänga b´ede ya mu̱dimehai nuua r´ayo manhyati:"	"Nüüa ya mǘdi noya ra motolinia, ha ra mǘdi nkohi bi t'ǫt'ë ko ra thuhu ra tratado tercero ra däŋa b'ede ya mǘdimehai nüüa r'ayo manhyati:"
"pa da t'unga mfädi gatho nu'u̱ bi nja, n'a di ge'u̱ ko ngu fe̱ti nu'a majuäni mi hoki mi thutsuabi ya hnei ne ya b'ida. b'u̱i man'a ra mfädi da t'o̱t'a ra nt'udi, nu'a ra thuhu ""fe̱ta nu'a majuäni bi nja nub'u̱ ra tsokat'o̱tamfeni (teatro de la conquista)""."	"Pa da t'unga mfädi gatho nu'u̱ bi nja, n'a di ge'u̱ ko ngu fe̱ti nu'a majuäni mi hoki mi thutsuabi ya hnei ne ya b'ida. B'u̱i man'a ra mfädi da t'o̱t'a ra nt'udi, nu'a ra thuhu ""fe̱ta nu'a majuäni bi nja nub'u̱ ra tsokat'o̱tamfeni (teatro de la conquista)""."
"ra europa -mra nxika hai manteb'u̱, mi pe̱tsa n'a ra nxika b'ede-"	"Europa -mra nxika hai manteb'u, mi pe̱tsa n'a ra nxika b'ede-"
"ra fernando ramírez mä ge nuna hyodi ri nge̱pu̱ habu̱ ja n'a ra nija ra san fernando ne ra ermita dige'a ya mártires dige'a san hipólito,"	"Ra Fernando Ramírez mä ge nuna jyodi ri ngë̱pü̱ habü̱ ja n'a ra nija ra San Fernando ne ra Ermita Dige'a Ya Mártires Dige'a San Hipólito,"
"ra fernando de alva ixtlilxóchitl, fernando de, xiii relación: ""ra ñ'ehe ya ñämfo̱ ne ra fu̱di ra nkanfri ra evangelio""."	"Ra Fernando de Alva Ixtlilxóchitl, Fernando de, XIII relación: ""Ra ñ'ehe ya ñämfo̱ ne ra fu̱di ra nkanfri ra Evangelio""."
"ra kuän'ahma ra n luz jiménez bi huts'i ra fernando horkasitas bi unga mfädi ne bi r'atsi nuña hmä), de porfirio díaz zapata, memoria nábuatl de milpa alta, méxico, unam,, instituto de investigaciones históricas, 1974, p. 105"	"Ra kuän'ahma ra n luz jiménez bi huts'i ra fernando horkasitas bi unga mfädi ne bi r'atsi nuña hmä, de porfirio díaz zapata, memoria náhuatl de milpa alta, méxico, unam, instituto de investigaciones históricas, 1974, p. 105"
"ra raymundo isidro alavez, bi b'u̱i'i nuni ra boxtha chico, san salvador, estado de hidalgo"	"Ra Raymundo Isidro Alavez, bi bʼuiʼi nuni ra Boxtha Chico, San Salvador, Estado de Hidalgo"
"ra hmä ra fundación de santo tomás ajusco, archivo general de la nación, méxico, ramo de tierras vol. 2676, expediente. 4, archivo histórico de la biblioteca nacional de antropología, colección antigua, vol. 254, fojas 259 r.- 260 v."	"Ra hmä ra Fundación de Santo Tomás Ajusco, Archivo General de la Nación, México, Ramo de Tierras vol. 2676, Expediente 4, Archivo Histórico de la Biblioteca Nacional de Antropología, Colección Antigua, vol. 254, fojas 259 r.- 260 v."
"ra makja mra thuhu ra toribio benavente, motolinia,"	"Ra makja mra t'uhu ra Toribio Benavente, Motolinia,"
"tlauhquechol: ra ts'ints'u̱ xa ntheni pode ge'a ra flamenco o ra guacamaya, pode ge gatho ra the̱nga ts'ints'u̱ ne dänga."	"Tlauhquechol: ra ts'ints'u xa ntheni pode ge'a ra flamenco o ra guacamaya, pode ge gatho ra thenga ts'ints'u ne danga."
"xkri tso̱ngä ngosthi, ja hehni ya 'ñu; nä'ä rí ma nxamädo, ha nä'ä rí ma mäbo̱za. antes de"	"xkri tsongä ngosthi, ja hehni ya 'ñu; nä'ä rí ma nxamädo, ha nä'ä rí ma mäboza. antes de"
"ya b'e̱go ne ya b'e̱tri di ge'a nu'a ra dänga ndä ra ndada ra thuhu ra esteban de guzmán ra nzaya di gekua m'onda, ra ndada ra hernando pimentel, ra ndada ra antonio cortés, ra ndada xuua (juan) nuna ra mecoyoacan, ra ndada pedro motecuhzoma, me ma r'a ya kuänmi (firmas)."	"Ya bʔego ne ya bʔetri di geʔa nuʔa ra däŋga ndä ra ndada ra tʔuhu ra Esteban de Guzmán ra nzaya di gekua mʔonda, ra ndada ra Hernando Pimentel, ra ndada ra Antonio Cortés, ra ndada xuua (Juan) nuna ra Mecoyoacan, ra ndada Pedro Motecuhzoma, me ma rʔa ya kuänmi (firmas)."
"ya kuän' ahmä xa thogi manteb'u̱e ge xa thäst'i nu'a gatho ra nthandi to'o bi b'e̱di ge xa pu̱ngahñä nuna hmä getbu̱ n'ate ya hñäki ge ñä ya nso̱ho̱ hñäki ne xa y'oni nuna nt'ofo nehe ha ra hñäki yazi xada jä'i , ge'a nuna hñäki fadi ha ra hñämfo ko ra thuhu ra sistema braile."	"Ya kuän' ahmä xa thogi manteb'u̱e ge xa thäst'i nu'a gatho ra nthandi to'o bi b'e̱di ge xa pu̱ngahñä nuna hmä getbu̱ n'ate ya hñäki ge ñä ya nso̱ho̱ hñäki ne xa y'oni nuna nt'ofo nehe ha ra hñäki yazi xada jä'i, ge'a nuna hñäki fadi ha ra hñämfo ko ra thuhu ra sistema braille."
"ya r'atsanoya ra sahagán, ndoxjua k'oi florentino, lib. xii, caps. xxix-xli (versión de ángel ma. garibay k.)."	"Ya r'atsanoya ra sahagán, ndoxjua k'oi Florentino, Lib. XII, caps. XXIX-XLI (versión de Ángel M.a Garibay K.)."
despwés ya desde k'a ra momento ya k'a ya híngi bénya'wi já té bimáhhu̱ k'a ra txarroya'wi	Despwés ya desde k'a ra momento ya k'a ya híngi béña'wi já té bimáhhu k'a ra txarroyá'wi
despwés ya xo bimu̱fí pe xo diario diario bu̱ ntxúi mitsu̱ k'a ra txarro mi'óbí k'a ra mikwála	Despwés ya sho bimfi pe sho diario diario bu ntxui mitsu k'a ra txarro miobi k'a ra mikwala
gopareháhé primero 'á k'a ra parte ánk'ú dínant'í	goparehahé prímero 'a k'a ra parte ankú dínant'í
i asta fecha pues ignoro mucho pero másk'ŭ mäjámá más ndímáignorahéwi	i asta fecha pues ignoro mucho pero máskʉ mäǵamá más ndímáignorahéwi
indu̱odiagí bastante	indu̱odiagí báste
"inga se̱he̱ ra nnthandi ra manhyati ne ra portuguesa nehe ra francesa, inglesa, alemana e italiana,"	"inga sehe ra nthandi ra manhyati ne ra portuguesa nehe ra francesa, inglesa, alemana e italiana,"
k'a mädämé para ke mantenigíhé dígothó mäbähtsí pues ni modo dísufréhé	k'a mädamé para ke mantenejíhe dígothó mäbahcí pues ni modo disúfrehe
kómá'u̱té ya fuente níhí	komahnte ya fuente nihí
"ne bi unbabi ndunthi ya baba, bi enbabi ge mi ne da ñäui ra ndä (emperador) mi b'u̱i nuni manhyati, ne da häni ra dänga ts'ofo ra evangelio,"	"Ne bi umbabi ndunthi ya baba, bi enbabi ge mi ne da ñäui ra ndä (emperador) mi b'ui nuni manhyati, ne da hani ra danga ts'ofu ra evangelio,"
normalmente góho	normalmente góho
panteón ga dó	Panteón ga dó
pero de sesenta pantsíthá pa gothók'ŭ kompletamente xathó ndímáfădihé	pero de sesenta pantsitha pa gothok'u kompletamente xatho ndimafadihe
pero eso sí binúhgí mängŭhé kada ná	pero eso sí binhngí mängühé kada ná
"po nuya ja'i to'o mi pede ge fädi ko ra thuhu ya ""cronistas de las indias"""	"po nuya xai to'o mi pede ge fädi ko ra tũhu ya ""cronistas de las indias"""
pues este kábádá balewa este mínimo siento sinkwenta	pues este kabada balewa este minimo siento sinkuenta
pues nimodo bisufré k'a más ante mäabwelitahé komo mbu̱i enkahoso ra ntsoya	pues nimodo bisufré k'a más ante mäabwelitahé komo mbu̱i enkahoso ra ntsoya
"ra nku̱t'i ra huahni ne ya ñ'udi nthutsi ra agustin yáñez 2da. edición. biblioteca del estudiante universitario, unam, 1950."	"Ra nkʉ̱tʼi ra huahni ne ya ɲʉdi nthutsi ra Agustín Yáñez, 2da edición, Biblioteca del Estudiante Universitario, UNAM, 1950."
solamente ya riko alkansabi	solamente ya ríhko alkansabi
xi ra tí na ta komedór 'á itsí na ta alimento k'a ra ndăni	Xi ra tí na ta komedor 'á itsí na ta alimento k'a ra ndani
xo mitahá ra ntsoya mitá sínko pesos ra béhña dos sinkwenta	Xo mitahá ra ntsoya mitá sinko pesos ra behña dos sinkuenta
xo taja mä sesenta wik'a taja mä sesenta bitahkíhéya'wik'a	Xo tajha mä sesenta hik'a tajha mä sesenta bitaxkíhéya'wik'a
á panteón ga dó níhí	á bpantéon ga dó níhí
ñúdigehña dabadihíya' razo''ya' mientra más dandu̱hté	ñiidigehña dabadihíya' razó''ya' mientra máas dandu̱hté
"-nu'u̱ dige'u̱ b'u̱i nuni maxey (tolimán ne amealco), dige'u̱ temoaya nuni ra ra hyodi estado de méxico ne mar'a ya hyodi nuni puebla ne veracruz"	"nu'u̱ dige'u̱ b'ui nuni maxei (Tolimán ne Amealco), dige'u̱ temoaya nuni ra ra hyodi Estado de México ne mar'a ya hyodi nuni Puebla ne Veracruz"
"ne mätahekitho di ja getbu̱, ra hñäpi ra joel martinez hernández ne ra hotho thuahmä ra natalio hernández xocoyotzin, nuya yoho ya xahnate ri ñ'ehe ya y'u̱ dige'u̱ ya ndeznä."	"Ne mätahekitho di ja getbū, ra hñäpi ra Joel Martínez Hernández ne ra hotho thuahmä ra Natalio Hernández Xocoyotzin, nuya yoho ya xahnate ri ñ'ehe ya y'ū dige'ū ya ndeznä."
"-n'ate pa n'a ra zänä de ra r'e̱t'a ma hñäto ""zänä"" mi zo̱ta ya munts'i ya n'ate ya pa ge mi hoki ra xihuitl o ""ra m'ede ra je̱ya"""	"N'ate pa n'a ra tsänä de ra r'ët'a ma hñäto ""tsänä"" mi tsota ya munts'i ya n'ate ya pa ge mi hoki ra sihui tl o ""ra m'ede ra héya"""
bi ma di gepu̱ ham''u̱ ra ngo pa da ts'ithe ya it'adehe (Tlahuano) ba po̱ni nubu̱ tlapechhuan. mra ngo ra Izcalli.	bi ma di gepṵ hamʔṵ ra ŋo pa da ts'itʰe ya it'adeʰe (Tlahuano) ba poṵni nubṵ tlapečʰuan. mra ŋo ra Izcālli.
bi mu̱di da hyoka ya t'u̱kats'u̱fabo̱ja. ge'a ra ntuhni bi nja nuni Coyohuehuetzin ne ma goho ba nja.	Bi mu̱di da joka ya t'ukats'ufabo̱dʒa. Ge'a ra ntuxni bi ɲa nuni Coyohuehuetzin ne ma goho ba ɲa.
"bri tho ra cuauhnochtli, ra gabida tlacatecco, ra cuapan, ra gabida huitznáhuac, ra makja Amantlan, ne ra makja tlacopan."	"bri tho ra cuauhnochtli, ra gabida tlacatecco, ra cuapan, ra gabida huitznáhuac, ra makja Amantlan, ne ra makja tlacopan."
bri ts'u̱tuabi ha ra y'u̱ga n'a ra nto̱de dega t'u̱ka hoga do dega chalchihuite: made mi huts'i n'a ra tsant'i dega k'astaboja.	bri ts'utuabi ha ra y'uga n'a ra ntode dega t'uka hoga do dega chalchihuite: made mi huts'i n'a ra tsanti dega k'astaboja
"Castañeda, ra t'u ra Aquiyahualcatecuhtli, m ra ndä nuni tlaxcala."	"Castañeda, ra t'u ra Aquiyahualcatecuhtli, m ra ndä nuni Tlaxcala."
Coaíhuitl mra gabida ndeznä nuya mapa digeá ra t'o̱t'ats' okamfeni.	Coaihuitl mra gabida ndeznä nuya mapa digea ra tohtatsʼ okamfeni
di gepu̱ ba koi pa nuni ra Xochimilco. nubu̱ ba tu ya jä'i ya metlatelolco	Di hëpũ ba koi pa nuni ra Xochimilco. Nubũ ba tu ya jä'i ya Metlatelolco
"ebu̱ ba ehe man'aki ba te̱nga ra t'o̱ho̱ ra thuhu ra Citlaltépec. Tlacopan, nubia ba o̱t'ra b'u̱i ha ra ndo̱m'ihmu."	"Ebu̱ ba ehe man'aki ba te̱nga ra t'o̱ho̱ ra thuhu ra Citlaltépec. Tlacopan, nubia ba o̱t'ra b'u̱i ha ra ndo̱m'ihmu."
ebu̱ bi dädi ra Cihuacóatl:	Ebu̱ bi dädi ra Cihuacóatl
ebu̱ bi ñä ra Cuauhtémoc bi xipabi ra Cihuacóatl:	Ebu̱ bi ñä ra Cuauhtémoc bi xipabi ra Cihuacóatl
"goho n'ate ya pa ne ebu̱ bi yopa bo̱ni pa di mani ra Huaxtepec, ra Cuauhnahuac (Cuernavaca)."	"Ngo̱ho n'ate ya pa ne ebu̱ bi yopa bo̱ni pa di mani ra Huaxtepec, ra Cuauhnahuac (Cuernavaca)."
"gue dá nhuat'i mbo ja ra ximhai,"	"nde dá ñuat'i mbo xa ra ximhai,"
"i nte ra nge'a, ya hmä huts'i ha ra ndäxjua k'oi ra códice ra ramírez uni nuna b'e̱de mä majuäni ngu mä ra nthe̱ka b'ede ne ra ndädi nu'a ra nänä mra thuhu ra yacotzin, ra nänä ra ixtlilxóchitl,"	"i nte ra ngē'a, ya hmä huts'i ha ra ndäxjua k'oi ra códice ra ramírez uni nuna b'ēde mä majuäni ngu mä ra nthēka b'ede ne ra ndädi nu'a ra nänä mra thuhu ra yacotzin, ra nänä ra ixtlilxóchitl,"
"inda hyo ko ra ndäxjua ixtlilxóchtil, ra dada ra Nezahualcóyotl ni ko ra fernando de alva ixtlilxóchitl."	"inda hyo ko ra ndäxjua ixtlilxóchtil, ra dada ra Nezahualcóyotl ni ko ra Fernando de Alva Ixtlilxóchitl."
"k o ya bu̱' bai, ko ya makahuai,"	"kʉ ya bu̱ʔ bai, kʉ ya makahuai,"
"mi fudi da t'axka ra xudi ba ts'i, bri thát'a ha n'a ra za mi b'ai ha ra ngu ra Ahuizotzin nuni ra Acatliyacapan."	"mi hudi da tʼaxka ra xudi ba tsʼi, bri thátʼa ha nʼa ra za mi bʼai ha ra ngu ra Ahuizotzin nuni ra Acatliyacapan."
mi gu̱t'a ra ñ'u̱ n'a ra makja ge'a mra b'e̱fi mi zu nu'a ra mäka hai mra thuhu ra Yohualichan.	mi ht'a ra ñ'u na ra makya ge'a mra befi mi zu nu'a ra maka hai mra tuhu ra Yohualichan.
"mi y'o y'oua, mi tuts'i ya bu̱'bai dega za, ne r'a mi hä dega bo̱ja ne ya mahuai."	"mi y'o y'oua, mi tuts'i ya bu̱'bai dega za, ne r'a mi hä dega bo̱ja ne ya mahuai."
mra ngu ra Aztautzin ge'a mi ja getbu̱ nuni ra Amáxac.	mra ngu ra Aztautzin ge'a mi xa getbũ̈ nuni ra Amáxac.
n'a ra hyo ne man'a bi xokuabi ra debi. ra Cuauhtemoctzin bri xokuabi ra debi ge'a se̱he̱.	N'a ra hyo ne man'a bi xokuabi ra debi. Ra Cuauhtémoc bri xokuabi ra debi ge'a sehe.
"ne m'e̱fa bi ma xki häki ya he dega magabi, ñätsi bi ntsaya ra mahuai ne ra bu̱'bai, bri njonda ya bo̱nahmu nuni Acachinanco."	"Ne m'efa bi ma xki haki ya he dega magabi, ñatsi bi ntsaya ra mahuai ne ra bu'bai, bri njonda ya bonahmu nuni Acachinanco."
"ne njabu̱ bri t'ot'e nehe ko mar'a ya bo̱nahmu mi pe̱tsi ra t'u̱ka tsu̱tui ha ya t'u̱ka hnini, nuyu̱ to'o mi b'e̱pi da t'o̱t'e ngu nuni Xalapan, Tlaxcalan, Tehuantepec, Oaxaca nehe mar'a ya bo̱nahmu mar'a ya t'u̱ka hnini habu̱ bi guat'i ya nduste, ya dumanthuhu dega k'astaboja, ge ya thuhu ya kristiano [...]"	"ne njabu̱ bri t'ote nehe ko mar'a ya bonahmu mi petsi ra tu̱ka tsutui ha ya tu̱ka hnini, nuyu̱ to'o mi be̱pi da tote ngu nuni Xalapan, Tlaxcalan, Tehuantepec, Oaxaca nehe mar'a ya bonahmu mar'a ya tu̱ka hnini habu̱ bi guati ya nduste, ya dumanthuhu dega k'astaboja, ge ya thuhu ya kristiano [...]"
"ne nu'a ri däme, pu̱ ñ'a'i, nugi ga ma ga tsogi'i nuni Cuetlachcoapan [n'a ra hnini nuni puebla],"	"ne nu'a ri däme, pu̱ ñ'a'i, nugi ga ma ga tsogi'i nuni Cuetlachcoapan [n'a ra hnini nuni Puebla],"
"ne nu'u̱ bi mani dra ts'okat'o̱t'amfeni nuni Michoacán, Xalisco, Culhuacan ne nuni nehe Pánuco, ne nuni Oaxaca, Tehuantepec ne Guatemala, ne nuua ra r'ayo mahyati, nub'u̱ bri t'o̱t'a ra mabagi pa dra uadi dra t'o̱t'a nu'a ra ts'okat'o̱t'amfeni inda tsogihe se̱he̱."	"Ne nu'u̱ bi mani dra ts'okat'o̱t'amfeni nuni Michoacán, Xalisco, Culhuacán ne nuni nehe Pánuco, ne nuni Oaxaca, Tehuantepec ne Guatemala, ne nuua ra r'ayo mahyati, nub'u̱ bri t'o̱t'a ra mabagi pa dra uadi dra t'o̱t'a nu'a ra ts'okat'o̱t'amfeni inda tsogihe se̱he̱."
"nehege'a ra ngätsi. mi hä ya mpe̱fi dega mabagi,ya njom'a te ne ya fu̱nbo̱ja, inte ma mahuai mi hä ni ge'a ya bu'bai."	"Nehege'a ra ngätsi. Mi hä ya mpe̱fi dega mabagi, ya njom'a te ne ya fu̱nbo̱ja, inte ma mahuai mi hä ni ge'a ya bu'bai."
njabu̱ bi bo̱nga dega xui. mra ngo nub'u̱ ra Tecuílhuitl bi bo̱nga: nub'u̱ bi ja ya du ha ra r'ani ra dehe ya u̱erna.	Njabu̱ bi bo̱nga dega xui. Mra ngo nub'u̱ ra Tecuílhuitl bi bo̱nga: nub'u̱ bi ja ya du ha ra r'ani ra dehe ya u̱erna.
"nub'u̱ bi thandi ra Tzihuacpopoca, bi t'ena:"	"nübʉ bi thandi ra Tzihuacpopoca, bi tʼena:"
"nub'u̱ ya ñämfo̱ bi handi ge xa ñ'ehe nubu̱ da tsu̱di, ge mi tekuabi ra nest'ihi, m'estho bi munts'i bi mihi ya mahuai."	"Nub'u̱ ya ñämfo̱ bi handi ge xa ñ'ehe nubu̱ da tsu̱di, ge mi tekuabi ra nest'ihi, m'estho bi munts'i bi mihi ya mahuai."
"nuna jä'i inbi tsa bi thädi majuäni nu'a ra nt'ani. ingra nge'a nuya pa bi hneki n'a ra hyoya jä'i ra macehual (hombre de pueblo),"	Nuna jä'i inbi tsa bi thädi majwäni nu'a ra nt'ani. Ingla nge'a nuya pa bi hneki n'a ra hyoya jä'i ra macehual (hombre de pueblo)
"nuna nte̱nga b'ede ha bri hat'i ra Tzihuacpopocatzin, bi o̱t'e da thogi ge'a ra ts'e̱y'e̱hmu. inbi bo̱nga nuna nt'o̱t'e bi tsu̱dihu̱ ko ma r'a ya b'e̱hni. ma ra ya ñ'ete inbi hopi da ju̱ man'aki ra ñ'u nuya ts'okate. pe nuya inbi hoki ra b'ai."	"Nuna ntēnga b'ede ha bri hat'i ra Tzihuacpopocatzin, bi ōt'e da thogi ge'a ra ts'ēy'ēhmu. Inbi bōnga nuna nt'ōt'e bi tsūdīhu ko ma r'a ya b'ēhni. Ma ra ya ñ'ete inbi hopi da ju man'aki ra ñ'u nuya ts'okate. Pe nuya inbi hoki ra b'ai."
"nuua di udihe ra hñäpi bi nto̱t'e bi nja ra agosto ra je̱ya 1595, n'a ra jä'i mra thuhu ra miguel hernández, ra me Chiyauhtzinco,"	"Nüüa di udie ra hñäpi bi ntöt'e bi nya ra Agosto ra yeya 1595, n'a ra yä'i mra tuhu ra Miguel Hernández, ra me Chiyauhtzinco,"
nuya bo̱nahmu ya mem'onda ñätsi bi ñäui ra Cihuacóatl Tlacotzin m'estho bi thädi:	Nuya bo̱nahmu ya mem'onda ñätsi bi ñäui ra Cihuacóatl Tlacotzin m'estho bi thädi
ra Tlacatécatl mra me Cuauhtitlan ne ra bktri ra mbot'a ngu bri japi ya tsat'yo bi zi.	ra Tlacatecatl mra me Cuauhtitlan ne ra baktri ra mbota 'ngu bri japi ya tsat'yo bi zi.
ra doy'e̱ pahni xki njom'i ko ya chalchihuite.	rai doy'e̱ pahni xki njom'i ko ya calchihuite
"ra mu̱di ra Cuauhtémoc, ra hmu ra bondo, ra nyoho ra Tlacotzin, ra Cihuacóatl ra nhñu ra oquiztzin, ra bo̱nahmu ha ra nini ra Azcapotzalco Mexicapan, ra ngoho ra panitzin, ra bo̱nahmu nuni ra Ecatepec,"	"Ra mu̱di ra Cuauhtémoc, ra hmu ra bondo, ra nyoho ra Tlacotzin, ra Cihuacóatl ra nhñu ra oquiztzin, ra bo̱nahmu ha ra nini ra Azcapotzalco Mexicapan, ra ngoho ra panitzin, ra bo̱nahmu nuni ra Ecatepec"
"ra mu̱di ra pa mi o̱t'e ra ngo ra mäkime ra u, ra thuhu ra Huixtocihuatl"	"Ra mu̱di ra pa mi o̱t'e ra ŋo ra mäkime ra u, ra tʰuhu ra Huixtocihuatl"
ra nge'a bi mu̱ni ko ra mahuai ha ra xu̱tha nu'a to'o bi umbabi ra ji.	Ra ngë'a bi muni ko ra mahui ha ra xutha nu'a to'o bi umbabi ra ji.
"ra nyoho, bi tho ra ndä ra Nauhtla, mra thuhu ra Cohualpopocatzin."	"ra ñojo, bi to ra nda ra Nauhtla, mra tuhu ra Cohualpopocatzin."
"unga ya ngue̱nda te ra ts'omu̱i mi bu̱'i ne mi japi da ntso̱m'i nuya macehualtin, njabu̱ mi thutuabi ya jä'i mi b'u̱i te ma za"	"Ŋga ya ŋge̱nda te ra ts'omu̱i mi bu̱'i ne mi xapi da ntso̱m'i nuya macehualtin, njabu̱ mi thutuabi ya jä'i mi b'u̱i te ma za"
"xib'u̱ bri fádi ge nuya he mi ja nuni ra cuauhchichilco, ha Xaltocan; ge mi pttsi ya ndá."	"xib'u̱ bri fadi ge nuya he mi xa nuni ra cuauhchichilco, ha Xaltocan; ge mi ptsi ya nda."
"xki mbo̱ni nubu̱ ra hyodi ra Cuehuecatitlan,"	"xki mbøni nubø ra jyodi ra Cuehuecatitlan,"
"xki thete ra Ixtlilxóchitl ne ra ku ra Cohuanacotzin ko ya he dega dänga ndä bi mu̱di da häni ra hoga ts'ofo ya evangelio,"	"xki thete ra Ixtlilxóchitl ne ra ku ra Cohuanacotzin ko ya he dega däŋga ndä bi mu̱di da häni ra hoga ts'ofu ya evangelio,"
"ya dänga ñu̱ni nsafi, ya nsafi, ya mahuai, hangu nu'u̱ gatho xki tagi mbo ha ra hñe."	"Ya däŋga ñuni nsahi, ya nsahi, ya mahuai, hangu nu'u gatho xki tagi mbo ha ra hñe."
"bi o̱tuabi nu'a ra makja xki nk'ohni mra thuhu ra alonso ruiz, ge mi y'o nuni huamuxtitan (Huamuxtitlan) nuni ra hyodi guerrero."	"Bi o̱tuabi nu'a ra makya xki nk'ohi mra thuhu ra Alonso Ruiz, ge mi y'o nuni Huamuxtitlan nuni ra hyodi Guerrero."
"di pädi xahño nuna b'e̱fi nehe yoho to'o di pädi da mpe̱fi da y'este nuya hoga do mahye̱gi ya xito, mra thuhu ra ambetz'ihuay."	"Di pädi xahño nuna b'ëfi nehe yoho to'o di pädi da mpëfi da y'ëste nuya hoga do mahyëgi ya xito, mra thuhu ra ambëtz'ihuay."
"dra thoki ra nto̱de, ra ketzal dra b'e̱ nuni Coyohuacan."	"Dra tʰoki ra ntʌ̱de, ra ketsal dra bʌ̱ nuni Coyohuacan."
e mi r'ani dega xui ra Cihuacóatl g'ea mi zoni ne mı mafi.	e mi rʼani dega xui ra Cihuacóatl gʼea mi zoni ne mı̄ mafi
"ebu̱ bi gäi habu̱ mi to̱ge ebu̱ bi yopa ma ha ra hnini ra Cuetaxtlan,"	"Ebu̱ bi gäi habu̱ mi to̱ge ebu̱ bi yopa ma ha ra hñini ra Cuetaxtlan,"
"ge'a ra mu̱di ra thuhu ra Hernando, ra nge'a njabu̱ mra thuhu ra takjä ra Cortés nehe njabu̱ mra thuhu ra ndä católico ne ra ku ra Cohuanacotzin bi thutuabi ra Pedro po ra Pedro Alvarado ra nge'a ra takjä,"	"He'a ra mudi ra tuhu ra Hernando, ra nge'a njabu mra tuhu ra tajä ra Cortés nehe njabu mra tuhu ra ndä católico ne ra ku ra Cohuanacotzin bi tutuabi ra Pedro po ra Pedro Alvarado ra nge'a ra tajä,"
"ma n'a mi b'ai nuni teotletso, habu̱ ra ñ'u̱ pa manjuäntho pa da zo̱ni nuni ra peñón (Tepetzinco)."	"ma n'a mi b'ai nuni teotletso, habu ra ñ'u pa manjuantho pa da zoni nuni ra peñón (Tepetzintli)."
"mi tso̱ho̱ getbu̱ ra fu̱nga t'o̱ho̱, habu̱ mi thutuabi ""tajón ra nxu̱ni, njabu̱ bi hutuabi ya ndeznä ya b'e̱hnanoya bi pe̱hni ra ts'e̱y'e̱hmu, mi gu̱t'a ra ñ'u ra Tzihuacpopocatzin, bi bo̱nga ha ra ñ'u."	"mi tso̱ho̱ getbu̱ ra fu̱nga t'o̱ho̱, habu̱ mi thutuabi ""tajón ra nxu̱ni, njabu̱ bi hutuabi ya ndeznä ya b'e̱hnanoya bi pe̱hni ra ts'e̱y'e̱hmu, mi gu̱t'a ra ñ'u ra Tzihuacpopocatzin, bi bo̱nga ha ra ñ'u"
mra ku ra Cacamatzin mra bo̱nahmu nuni Tetzcoco mri ñ'oui va jä'i mi y'o mpaha.	Mra ku ra Cacamatzin mra bo̱nahmu nuni Tetzcoco mri ñ'ui va jä'i mi y'o mpaha.
"n'a ra nto̱de dega chalchihuite, xi m'et'e dega ze̱ka do, nehe mi pe̱tsi n'a ra tsant'i de ga k'astaboja."	"N'a ra ntōde dega chalchihuite, xi m'et'e dega zēka do, nehe mi pētsi n'a ra tsanti de ga k'astaboja."
ne ndunthi ya ambetz'ihuay ne mar'a hoga do mi pe̱tsi ra mu'ui:	ne ndunthi ya ambec'ihuai ne mar'a hoga do mi pe̱tsi ra mu'ui
nehe n'a ya the̱sthi dega mboťahuaido.	nehe n'a ya the̱sti dega mbotoaidu.
"nuna bi o̱t'a ra ntso̱m'i ra nge'a nehe nuya ya b'e̱datsi bi tsini ko ra Cortés ne ra Cohuanacotzin ne ra ixtlilxóchitl xki nsofo pa ra ixtlilxóchitl da gu̱ka ya jä'i ge mi zu ya hyodi, njabu̱ mi pe̱hna ajuä da t'o̱t'e."	"Nuna bi o̱t'a ra ntso̱m'i ra nge'a nehe nuya ya b'e̱datsi bi tsini ko ra Cortés ne ra Cohuanacotzin ne ra ixtlilxóchitl xki nsofo pa ra ixtlilxóchitl da gu̱ka ya jä'i ge mi zu ya hyodi, njabu̱ mi pe̱hna ajuä da t'o̱t'e."
"nuna nt'o̱t'e bi nthandi xa nts'ogi njabu̱ bri thutuabi, bi ena ge mra nzu̱te ko ma m'u̱hai ra nzu̱te ne mi thutsuabi ko ya mpe̱bi dega mabagì, habu̱ hmä ge n'a di ge'u̱ bi y'e̱nga n'a ra do, ko nge'a bi hyo, nu'u̱ mar'a ya b'e̱go ge mä ge nu'u̱ se̱he̱ ya ñämfo̱ bi hyo bi mu̱tu'a n'a ra mahuai ha ri ngati bi mu̱tuabi n'a ra nzu̱ni."	"Nuna nt'o̱hte bi nthandi xa nts'ogi njabu̱ bri thutuabi, bi ena ge mra nzu̱te ko ma m'u̱hai ra nzu̱te ne mi thutsuabi ko ya mpe̱bi dega mabagi, habu̱ hma̱ ge n'a di ge'u̱ bi ye̱nga n'a ra do, ko nge'a bi hyo, nu'u̱ mar'a ya be̱go ge ma̱ ge nu'u̱ se̱he̱ ya ña̱mfo̱ bi hyo bi mu̱tu'a n'a ra mahuai ha ri ngati bi mu̱tuabi n'a ra nzu̱ni."
"ra Cuauhtémoc, Tlacotzin, ra Cihuacóatl, Oquiztzin, Panitzin, Motelhuihtzin; nuna bi sofo ra Cortés nuni Coyoacan, nu'u̱ to'o mi pädi yoho ya hñäki ngu'a ra jerónimo aguilar ra malintzin."	"ra Cuauhtémoc, Tlacotzin, ra Cihuacóatl, Oquiztzin, Panitzin, Motelhuihtzin; nuna bi sofo ra Cortés nuni Coyoacan, nu'u̱ to'o mi pädi yoho ya hñäki ngu'a ra Jerónimo Aguilar ra Malintzin."
t'ena ge ya macehual [ya jä'i b'u̱i ha ra hyoya]	tʔena ge ya masehual [ya xä'i bʼui ha ra jyoja]
"xki thokuabi nuya hotho ts'ints'u̱ mra thuhu ra ""tlauhquecho"" ne “tzinitzcan zacuan"","	"xki thokuabi nuya hotho ts'ints'u̱ mra thuhu ra ""tlauhquecho"" ne “tzinitzcan zacuan”"
-¿te be'a gi mä nu'i Cihuacóatl?	-¿te be'a gi mä nü'i Cihuacóatl?
"bi k'ahni ko ya dänga ñuni nzafi ne bi thetse ko ya makahuai nuya otomi geb'u̱ bi japi bi b'e̱di, bi mä nuyu̱:"	"bi k'ahni ko ya dänga ñuni nzafi ne bi thetse ko ya makahuai nuya otomi geb'u bi japi bi b'edi, bi mä nuyu"
da thuts'i ya njot'ihñä ( )	dá t'uts'i ya ñjot'ihñä
"da umbabihe te da zi, da japabihe ndunthi ma zu."	"dá ūmbábihé te dá zí, dá japábihé ndūnthí má zū."
ebu̱ bi mä nuna b'e̱fi xa thoki xahño bi johya ra ts'e̱y'e̱hmu.	Ebu̱ bi mä nuna b'e̱fi xa thoki xahño bi johya ra ts'e̱y'e̱mu
"fernando alva ixtlilxóchitl, xiii njändahmä ""ra ñ'ehe ya ñämfo̱ ne ra mu̱di ra hoga ts'ofo ra evangelio."""	"Fernando Alva Ixtlilxóchitl, XIII njändahmä ""ra ñ'ehe ya ñämfo ne ra mu̱di ra hoga ts'ofo ra Evangelio."""
"ga juatihu̱ nu'a huts'i njani, ya ts'ojä'i, ra carranza, ge xa o̱t'a ya ts'okuate pa gekagihu̱; ga o̱t'e da nja ra ts'e̱di ma munts' ne njabu̱ ga tsu̱dihu̱ da nja nu'a ra hoga tsu̱tui, da nja ra hai, ra hñegi ne ra hoga ts'u̱tui;"	"ga juatihu nu'a huts'i njani, ya ts'ojä'i, ra Carranza, ge xa ota ya ts'okuate pa gekagihu; ga ote da nja ra ts'edi ma munts' ne njabu ga tsudihu da nja nu'a ra hoga tsutui, da nja ra hai, ra hñegi ne ra hoga ts'utui;"
gatho ya hyoyajä'i mi b'u̱i ha ra hnini bi handi.	gato ya joyajä'i mi bʉi ha ra hnini bi handi.
"ha bi häni ra ñ'udi, ma jä'ihu̱ bi ent'i gatho mahye̱gi nuya nzu̱te"	"Ha bi hɨɨni ra ŋ'udi, ma jɑ'ihu ɓi ent'i gatho mahyɛɛgi nuya nzɨte"
"ha n'aa nza̱tho xudi ra pale berto, bi bo̱ni nda hyonga te nda nzimxidi ngetho nda zi ya hme hyaxtho mi u̱xa ya u, ua ngu mi nzäi mi nkahui yá hme nuya txuju̱ xa hogi ha nuya 'bomuha̱i nts'ät'i, nt'o̱kuä;"	"Ha na̱a nzatho xudi ra pale Berto, bi boni nda hyonga te nda nzimxidi ngetho nda zi ya hme hyaxtho mi uxa ya u, ua ngu mi nza̱i mi nkahui yá hme nuya txuju̱ xa hogi ha nuya 'bomuha̱i nts'at'i, nt'o̱kuä;"
"ha nubia di ndäki, di ndändiñähmu, di ma ga ts'u̱tsa'i ri y'e, ga ndäne'i ra nge'a nu'a'i ma makjahe, ra bartolomé lópez, nub'u̱ mi njuäni ma b'e̱hña inbi njuäni ha nubu̱ mi xaxi pa da o̱t'a ya tso̱mfen"	"Ha Nubia di ndäki, di ndändiñähmu, di ma ga ts'utsa'i ri y'e, ga ndäne'i ra nge'a nu'a'i ma makjahé, ra Bartolomé López, nub'u mi njua'ni ma b'ehña inbi njua'ni ha nubú mi xaxi pa da o't'a ya tso'mfen"
"ha ya t'u̱ka ze̱ki thuts'i n'a tu̱kitho nuna thogi ge bi huxa ra fernando alva ixtlilxóchitl, nu'a b'e̱tsi ra xiiii njondahmä."	"Ha ya t'uka zeki thuts'i n'a tukitho nuna thogi ge bi huxa ra Fernando Alva Ixtlilxóchitl, nu'a bets'i ra XIV njondahmä."
habu̱ ga ju̱he nuyu̱ (ya tenochcas) te gi honihu̱?	Habų ga jųhe nųyų (ya tenochcas) te gi hŏnihų?
"ham'u̱ gatho ya juän'ahmä ge nuua xa ze̱ti ri ñ'ehe dige'a ya noya ya mu̱dimehai ha ra hñä ya ndeznä, nuna thuhu ri uni inga se̱he̱ ra n'atsanoya pa da fädi ra hñämfo̱, ingi ri me̱udi dige'a ra hmä fu̱oti dige'a nuna ra hñäki ra netzahualcoyotl. ne ra cuauhtémoc."	"hamʉ̱ gatho ya juänʔahmä ge nuua xa ze̱ti ri ñʔehe digeʔa ya noya ya mu̱dimehai ha ra hñä ya ndeznä, nuna thuhu ri uni inga se̱he̱ ra nʔatsanoya pa da fädi ra hñämfo̱, ingi ri me̱udi digeʔa ra hmä fu̱oti digeʔa nuna ra hñäki ra netzahualcoyotl. ne ra cuauhtémoc."
mi hneki ngu ma jä'ihu̱ ngabu̱ mri hneki.	mi ñeki ngu ma xáʔiŋu ngabu mri ñeki.
"ndunthi bri johya, bri thuxpabi gatho nu'a mi o̱t'abi ra b'edi, ko nge'u̱ bi m'u̱i ne mi t'umbabi ya t'ixu:"	"ndunthi bri johya, bri thuxpabi gatho nu'a mi o̱t'abi ra b'edi, ko nge'u̱ bi m'u̱i ne mi t'umbabi ya t'ixu"
"ngu mra me̱ti, nu'a r'a hyodi, habu mi y'o, n'a ngu n'a mi johya mi mfe̱m'a xinxi xi mi johya ya ndäte, mi thede n'a ngu n'a mi hñu̱fi ne mi fe̱m'a ya xinxi: xi mi b'u̱i mpaha."	"Ngu mra me̱ti, nu'a r'a jyodi, habu mi y'o, n'a ngu n'a mi johya mi mfë̱m'a xinxi xi mi johya ya ndäte, mi thede n'a ngu n'a mi hñu̱fi ne mi fë̱m'a ya xinxi: xi mi b'u̱i mpaha."
"njabu̱ ri ñ'ehe ya je̱ya inda m'e̱di, inda mpumfri, ga nzäi ga pe̱tsi nugagihu̱ ha ma mfenihu̱, ga pe̱tsi nugagihu̱, ra bätsi dige'u̱, ya b'e̱to, ya ntsaniku, ya mbänga b'e̱to ne to'o dra ñ'epu̱, to'o mahye̱gigihu̱, ma jihu̱, ya ku̱hu̱."	"Njabu̱ ri ñ'ehe ya je̱ya inda m'e̱di, inda mpumfri, ga nzäi ga pe̱tsi nugagihu̱ ha ma mfenihu̱, ga pe̱tsi nugagihu̱, ra bätsi dige'u̱, ya b'e̱to, ya ntsaniku, ya mbänga b'e̱to ne to'o dra ñ'epu̱, to'o mahye̱gigihu̱, ma jihu̱, ya ku̱hu̱."
"nu xä oth'u̱, ma gä ñ'jähu̱"	"nu xä oth'u, ma gä ñjähu"
"nuga̱ xi di ne'i, hindi pädi hanja..."	"nuga̱ xi di ne'i, hindi päti hanja..."
"num'u̱ di johyahu̱, nkuehu̱, nts'o̱mihu̱, tsuhu ne pa da t'o̱xkähu̱ di hohñu̱ nu ya nt'u̱i xi di 'yoohu̱ (¡!). nuya da nt'ot'i ko ra dänt'ot'í"	"numʉ̱ di joyahʉ̱, nkʉehʉ̱, ntʉsʉ̱mihʉ̱, tsʉhʉ ne pa da tʉxkähʉ̱ di hohñʉ̱ nʉ ya ntʉ̱i xi di ʼyohʉ̱ (!). nʉya da ntʉotʉi ko ra däntʉotʉi"
"nuna bi johya ha ra mabagi,"	"nuna bi joya ha ra mabagi,"
"nuya hñu o gohoya pa bi b'u̱i nubu̱ bi xitsuabi ra jäpadehe ndunthi ya jä'i, ngu xa t'ena."	"Nuya hñu o gohoya pa bi bʼui nubuʼ bi xitsuaʼbi ra hapadehe ndunthi ya haʼi, ngu xa tʼena."
"nuya tsat'io mi b'et'o, mi gu̱t'a ra ñ'u, mi teni, ya xiñu mi ju̱ts'i pa mañä, xi mi pähä gatho mi handi mi nest'ihi: mi tu̱ta ya jihni"	"Nuya tsatiʔo mi beʔto, mi gu̱ta ra ñu, mi teni, ya xiñu mi ju̱tsʔi pa mañä, xi mi pahä gato mi handi mi nestʔihi: mi tu̱ta ya jihni"
"pe, nu'i ndada nu'i ma t'ek'ei ra makja, nub'u̱ nu'i ingi zugagihe, ¿hanja, nuua, ra hyo di ge'a, ga tsogi nubu̱ [nu'a ma b'e̱hña]?"	"pe, nu'i ndada nu'i ma t'ek'ei ra makxa, nub'u nu'i ingi zugaxihe, ¿hanxa, nuua, ra hyo di ge'a, ga tsogi nubu [nu'a ma b'ehña]?"
"r'a ya jä'i mi b'u̱i ha ra ngumi ja nunu ha ra hnini ri manjuäntho pa da tsoni nubu̱ ra amáxac,"	"r'a ya jä'i mi bʉi ha ra ngumi ja nunu ha ra hnini ri manjuäntho pa da tsoni nubʉ ra amáxac,"
"ra nge'a di o̱t'a nuna noya ra ts'u̱tui ne gatho to'o da guat'a ha ma hyohe, nu'u̱ to'o da ne, da me̱tsi n'a ra hoga m'u̱i ne da m'u̱i manjuänthä. ha nubu̱ xa mabu̱ ma noya ge di pe̱tsi ra tsa, dega hoga jä'i ne dega hogat'o̱t'antuhni"	"Ra ngë'a di o̱t'a nuna noya ra ts'ü̱tui ne gatho to'o da guat'a ha ma hyohe, nu'u̱ to'o da ne, da me̱tsi n'a ra hoga m'ü̱i ne da m'ü̱i manjuänthä. Ha nubü̱ xa mabü̱ ma noya ge di pe̱tsi ra tsa, dega hoga jä'i ne dega hogat'o̱t'antuhni"
ra ngehna nuna pa bi ma n'a ra ñ'u manjuäntho.	ra ngëhna nuna pa bi ma n'a ra ñ'u manjuantho
"ra nhñu ne ra ngästsi ra b'ist'ofo di huts'ihu̱ ha nuna ze̱ki b'ist'ofo, ri ñ'ehe ra vii njondahmä ra chimalpain,"	"Ra nhñu ne ra ngätsi ra b'ist'ofo di huts'ihu ha nuna zeki b'ist'ofo, ri ñ'ehe ra vii njonda hmä ra chimallpain,"
"ra nthädi ra cuitlahuacatzin bi ena ge ina da o̱t'e nuya bi b'e̱pabi ya nso̱ho̱jä'i,"	"ra ntʰädi ra kʷitlawaʦin bi ʔena ge ina da o̱tʔe nuja bi bʔepabi ja nsʔoho̱jäʔi,"
"ra nyoho nu'a mi zu ra tepoztlan; ra nhñu ra me tizatlan, ra njoho mi ñ'ehe nuni huehuetlan ne ra nku̱ta mra dänga mictlan."	"rai nyoho nu'a mi tsu rai tepoztlan; rai nhñu rai me tizatlan, rai njoho mi ñ'ehe nuni huehuetlan ne rai nkuta mra däŋga mictlan."
ri ñ'udi xahño nubia hanja beni ya metlaxcala bi do̱m'i mpaha nuya nso̱ho̱ jä'i.	ri ñudi xajño nubia hanja beni ya metlaxcala bi dom'i mpaha nuya nsoho jäi.
"t'ena ge inbi unga mfädi pa gatho ya jä'i mi ñ'oui, ge nuna ndada ra marqués da ñ'ehe dra hmu ha ma haihe, da ja me̱ti nu'a di pe̱tsihe nehe dra jakagihe ga mpe̱fihe ra hai ge bi umbabi o bi hänbabi ya hoga hai ya n'añ'o hnini."	"tʔena ge inbi unga mfäði pa gaθo ya ʒaʔi mi ñʔui, ge nuna ndada ra marqués da ñʔehe ðra hmʷu ha ma haihe, da ʒa me̱ti nuʔa ði pe̱ʔʦihe nehe ðra ʒakaʒihe ga mpe̱fihe ra hai ge bi umbabi o bi hänbabi ya hoga hai ya nʔañʔo hnini."
"xi mi taxki ra ñ'u, imbi tsa da r'anga n'a, ho̱nse̱he̱ mi taxka n'a ha ra bo̱hai. ya y'ofadi mi ju̱t'atho."	"Xi mi taxki ra ñ'u, imbi tsa da r'anga n'a, ho̱nse̱he̱ mi taxka n'a ha ra bo̱hai. Ya y'ofadi mi ju̱t'atho."
"ya dänga mfu̱nga bo̱jä bi ntho, bi kot'i ko ya mahjuai, mi zu̱m'i nehe ko ya t'e̱nga ts'u̱t'abo̱ja."	"Ya däŋga mfu̱ŋga bojä bi n̄tho, bi kot'i ko ya mahjuaí, mi zum'i nehe ko ya t'äŋga ts'ut'aboja."
ya r'atsanoya ra sahagún mi mä hanja mi yopa tsini. ya ndeznä bi nkohi inda ñ'udi. mi hatatho pa bi mu̱di ra ntuhni	Ya r'atsanoya ra Sahagún mi mä hanja mi yopa tsini. Ya ndeznä bi nkohi inda ñ'udi. Mi hatatho pa bi mu̱di ra ntuhni
"ya zi b'e̱hña mi ägi ha ya b'a ne ha ya ngo̱de, nuya ñ'o̱ho̱ mbo ha ya ne, ha ya njom'ahudi."	"Ya zi be̱hña mi ägi ha ya ba ne ha ya ngo̱de, nuya ñ'o̱ho̱ mbo ha ya ne, ha ya njom'ahudi."
"bi boxro xi 'be̱ts'ina, bido'u̱ ro 'yu̱ni 'na, xi bi bo̱x ro hjua 'na, bido'u̱ ro ts'ii 'na, xi bo̱xro ts'äre 'na. ge'bu̱ go min pu̱n doja 'na."	"Bi boxro xi bets'ina, bido'u ro yuni na, xi bi box ro hua na, bido'u ro tsii na, xi boxro tsare na. Gebru go min pun doja na."
bi ma manjuäntho habu̱ mi b'u̱i ra ts'e̱y'e̱hmu bi xipabi;	bi ma manju̱antho habu̱ mi b'ui ra tse̱y'e̱hmu bi xipabi;
bri juahni po nuya dra hmu.	bri juahni po nuya tra hmu
"di to̱m'ihe ra ñ'ethi pa nugagihe, n'a ra pa ngu ma n'a ra pa thogi nekagihe di huadihe ra nge'a indi tse̱tihe nuna b'u̱i t'o̱t'e ko ngekagihe man'año ya ntho, t'e̱nts'igihe thi ma haihe ma me̱tihe, ju̱kagihe ga mpe̱fihe ndunthi, b'e̱kagihe ga jut'ihe xdunthi ya boja, n'a ngu n'a ra pa nuna njut'i di o̱t'ehe man'a te ma thaihe di tuhe."	"di tomʔihe ra ñʔethi pa nugagihe, nʔa ra pa ngu ma nʔa ra pa thogi nekagihe di huadihe ra ngeʔa indi tseʔtihe nuna bʔui tʔoʔtʔe ko ngekagihe manʔaño ya ntho, tʔeʔntsʔigihe thi ma haihe ma meʔtihe, juʔkagihe ga mpeʔfihe ndunthi, bʔeʔkagihe ga jutʔihe xdunthi ya boja, nʔa ngu nʔa ra pa nuna njutʔi di oʔtʔehe manʔa te ma thaihe di tuhe."
gatho nuna hai ha nuna r'ayo ximhai njabu̱ bi thutuabi nuya nso̱ho̱jä'i inbi tsa bi thutuabi man'a ra thuhu.	Gatho nuna hai ha nuna r'ayo ximhai ñabu̱ bi thutuabi nuya nsōhōjä'i inbi tsa bi thutuabi man'a ra thuhu.
"ha mi tso nde, bi mu̱di bi nja n'a ra hneki ngu njagihu̱ dega jä'i, bi t'ot'e ra b'ai ngu dega jä'i,"	"Ha mí tso ndé, bi múdi bi nya n'a ra hnéki ngu nyagíhu degá yá'i, bi t'ot'e ra b'ai ngu degá yá'i,"
"ma bo̱nahmu'ihe: nuna b'e̱fi ga tsokagihe sta juatihe gatho: gi nuti nuua, xa hño bo̱nahmu."	"Ma bonahmu'ihe: nuna be'fi ga tsokagihe sta juatihe gatho: gi nuti nu'a, xa hño bonahmu."
"mi mä dega ts'e̱dira hñä tso̱pu da ts'o̱ho̱bu nuya nzo̱ho̱jä'i ga handihu̱ te ma ts'e̱di pe̱tsi, ra nge'a ma ajuä ra quetzalcohuatl b'u̱i nuua ko ngekagihu̱,"	"mi mä dega ts'edirah ñä tso̱pu da ts'o̱ho̱bu nuya nzo̱ho̱jä'i ga handihu̱ te ma ts'edi pe̱tsi, ra nge'a ma ajua ra quetzalcoatl b'u̱i nuua ko ngekagihu̱"
"ne ya nt'u̱i, hanja di thuts'i ya nt'ofo, njap'u̱ nehe mä 'ra ya mpeu̱i da fats'i di nt'ot'i ra hñähñu"	"ne ya ntʉ̱i, hanja di tʉtʃʼi ya ntʼofo, ɲapʉ̱ nehe mä ’ra ya mpʉ̱i da fatsʼi di ntʼotʼi ra hɲäɲu"
"nub'u̱ nu'i ingi japi da bo̱nga nu'a ra makja ha nu'a ra hnini, ¿hanja ra yotui, ga tso̱gi nubu̱ ma b'e̱hña? o̱t'a r'ato ya je̱ya bi mu̱di [ra makja ra bartolomé lópez]"	"Nub'u̱ nu'i ingi japi da bo̱nga nu'a ra makja ha nu'a ra hnini, ¿hanja ra yotui, ga tso̱gi nubu̱ ma b'e̱hña? o̱t'a r'ato ya je̱ya bi mu̱di [ra makja ra Bartolomé López]"
pa ga b'u̱i mpaha ne ga o̱t'e n'a ra njondahmä gatho nu'a ga handi.	Pa ga bʉi mpaha ne ga ʔtʔe nʔa ra ñondaᵐmä gato nuʔa ga jandi.
"r'a nuna mi nthandi ngu nu'a ma thänjuahu̱ (ychtlilmatli), xi mra nts'o, mi kuet'e ha ya ngo̱,"	"r'a nuna mi ntʰandi ŋu nu'a ma tʰäŋjuahu (yxtlilmatli), xi mra ntso, mi kuet'e ha ya ŋo,"
"xa zägi mpaha, nub'u̱ xa njabu̱ xa japabi ma zu ne inte xa t'o̱tuabi nub'u̱ inda japi xa po̱ho̱ bi ya kue̱ ra nge'a ya jä'i xi mra no̱t'e ne mra hyotejä'i,"	"Xa zägi mpaha, nub'u xa njabu xa japabi ma zu ne inte xa t'otuabi nub'u inda japi xa poxo bi ya kue ra nge'a ya jä'i xi mra no't'e ne mra hyotejä'i,"
"y'o, ri ma ne gi xipabihu̱ ya metlaxcala ge ma r'a ya me̱ti jä'i ne ri ajuähu̱, ge nu'a ga mä ge xa ehe nuua ma haihu̱, ge di umbabihe ma nthädihe."	"yʔo, ri ma ne gi xipabíhu̱ ya Metlaxcala ge ma rʔa ya me̱tí jäʔi ne ri ajü̱áhu̱, ge nuʔa ga mä ge xa ehe nuúa ma haihu̱, ge di umbabíhe ma nthädíhe."
¿te da o̱t'e ma jä'ihu̱ sta b'e̱dihu̱?	¿te da o̱tʔe ma ɟäʔihu̱ sta bʔëdihu̱?
"-da ts'iua:... ri ñ'ehe ge'a ma njueih'u̱. da o̱t'ehe ya ñ'o̱te ko ya he̱m'i, ya ñ'o̱t'ehe ko ya ntuts'i. da o̱ts'e̱ ra b'e̱na noya."	"-da ts'iua:... ri ñ'ehe ge'a ma njueih'u. da o̱t'ehe ya ñ'o̱te ko ya hem'i, ya ñ'o̱t'ehe ko ya ntuts'i. da o̱ts'e̱ ra b'e̱na noya."
-dom'i ma ajuähu̱ ge inda yu̱t'a ha ma nguhu̱ nuhu̱ to'o e̱nts'i pa thi ne da hokuabi ra honanhyo nub'u̱ sta ne da hyoki ya inda za.	-domi ma ajua̱hu̱ ge inda yu̱ta ha ma nguhu̱ nuhu̱ to'o e̱ntsi pa thi ne da hokua̱bi ra honanhyo nubu̱ sta ne da hyoki ya inda za
"-o̱t'a ra mäte gi o̱dehu̱, ja gi b'ai nuuahu̱. mont'a ya ngo ajuä; ri juat'i ra ngo ga tsunda ma ajuähe."	"-ot'a ra mäte gi odehu, ja gi b'ai nuuahu. mont'a ya ŋo ajüä; ri juat'i ra ŋo ga tsunda ma ajüähe."
"-xa hño, di b'u̱ihe njamädihe."	"ȝa hño, di bʼuihe ñamädihe."
-¿nguande njabu̱ ga mäu gra juähu̱?	-¿Ngwandē njabū ga mäū gra juāhū?
"-ñ'emabagi, ya gabida, ya jä'ihu̱ gi pädi ra ntuni ra mem'onda ba ehehu̱ ga te̱nihu̱ma nzu̱tehu̱. ko ya mätsa mi te̱he̱, ko ya bu̱'bai ko ngatho ra ts'e̱di mi te̱he̱ ra ñ'u."	"-ñ'emabagi, ya gabida, ya jä'ihu gi pädi ra ntuni ra mem'onda ba ehehu ga te̱nihu̱ma nzu̱tehu̱. ko ya mätsa mi te̱he̱, ko ya bu̱'bai ko ngatho ra ts'e̱di mi te̱he̱ ra ñ'u."
"bi tse̱ti nuna ngot'i ra m'onda, ngu pede ra dänga b'ede, ya k'oi ne ya njändahmä, ngu nu'a ra hmä ra alonso axayaca, goho n'ate ma pa bi nzo̱t'e nuna pa."	"bi tse̱ti nuna ngot'i ra m'onda, ngu pede ra dänga b'ede, ya k'oi ne ya njändahmä, ngu nu'a ra hmä ra alonso axayaca, goho n'ate ma pa bi nzo̱t'e nuna pa."
"into y'o manjuäntho, into pa ri nektho."	"into yʼo manjuänhto, into pa ri nekhto"
"nub'u̱ ndi umbabihe ma njut'ihe xki nzäi ndi da'ihe, mi adi n'a tu̱ki nehe nub'u̱ ndi unihe ya k'astaboja mi häni made n'a tu̱ki [...]"	"nubʉ̱ ndi umbabihe ma njutʉ̱ihe xki nzäi ndi daʉihe, mi adi nʉa tu̱ki nehe nubʉ̱ ndi unihe ya kʉastaboja mi häni made nʉa tu̱ki [...]"
"ya miñ'o ko ngehna hmä ri johya,"	"ya miño ko ngeña hmä ri joya,"
bi tso̱hso̱ ra ngo ma ajuähu̱: nubia da fu̱di da guadi ra r'e̱t'a ra pa.	bi c'o̱hso̱ ra ŋo ma ajü̱ä: nubia da fü̱di da gwadi ra r'ä̱t'ä ra pa.