Input	Result
"-pasadores: ""ya nts'äza xi mra nts'u̱t'i mi t'e̱ni ko n'a ra t'e̱nga ts'u̱t'a bo̱kja mi tjutuabi ra ballesta""."	ya ntzaʼa ɨi mra ntʼutʼi mi tʼeɨni ko nʼa ra tʼeɨnga tʼutʼa bokya mi tʃutuabi ra ballesta
"cantares mexicanos, biblioteca nacional de méxico, ya nt'ofo 1628 bis, folio 16 v."	"Cantares mexicanos, biblioteca nacional de México, ya nd'ofo 1628 bis, folio 16 v."
"ebu̱ bi bo̱ni, bi meui nuni nonohualco, ja ra ngu ra b'ongui jabu̱ ra gabida ne ra malintzin ne ""ra jyadi"" (alvarado) ne ra sandoval."	"Ebu̱ bi bo̱ni, bi meui nuni nonohualco, ja ra ngu ra b'ongui jabu̱ ra gabida ne ra malintzin ne ""ra jyadi"" (Alvarado) ne ra Sandoval."
gi jandi ra nt'ofo ra tjuju ra crónicas de la conquista	gi xandi ra nt'oho ra tyuhyu ra crónicas de la conquista
"guzmán. ja ya je̱m'i b'e̱tsa kje̱ya manteb'u̱ di ge nuua m'onda ne ya jyo, nu'a ra jmä ra 12-conejo (1530) ge xa jmä ge xibú bi yut'i ja ra culhuacan ya ndeznä, nda pablo xochiquetzin, motelchiuhtzin ne ra guzman."	"Guzmán. Ja ya je̱m'i b'e̱tsa kje̱ya manteb'u̱ di ge nuua m'onda ne ya jyo, nu'a ra jmä ra 12-conejo (1530) ge xa jmä ge xibú bi yut'i ja ra Culhuacan ya ndeznä, Nda Pablo Xochiquetzin, Motelchiuhtzin ne ra Guzmán."
"ja ga ñ'udiju̱ ra nt'ofo ya ñämfo̱ po ra ntjuts'i ra doctor garibay,"	"ja ga ñ'uɟiu ra nt'ofu ya ñämfu po ra ntjuts'i ra doctor Garibay,"
ja nu'a jyodi nubia tjutuabi ra san martin.	ja nu'a jyodi nubia tjutuabi ra San Martín.
"je̱mi unga mfädi ja ra t'u̱ka jnini jabu̱ b'u̱i ya kjä'i teni ra división ra arenas, 27 ra abril ra kje̱ya 1918, ra m'ets'a je̱m'i ra zapata, b'e̱tsi ja ra universidad nacional autónoma de méxico, expediente 29."	"Hëmi uŋa mfädi ja ra t'uka jnini jabu b'ui ya kjä'i teni ra división ra arenas, 27 ra abril ra këya 1918, ra m'ets'a hëmi ra zapata, b'etsi ja ra universidad nacional autónoma de méxico, expediente 29."
"m'e̱fa ja ra jñuti bri tjätuabi na ra jñe xki tagiri mo̱te, neje bri kjom'a ra xu̱tja ko n'a ra t'axa dutu mra tjujuu ra ""campanillante""."	"mʔefa ja ra ɟñuti bri tɟätuabi na ra ɟñe xki tagiri moʔte, neje bri kɟomʔa ra xuʔtɟa ko nʔa ra tʔaxa dutu mra tɟuɟuu ra ""campanillante""."
"ma dada'ije gra ts'u̱tui, di ne gi pädi ge ma me̱t'o instä tjogije nuna tjogi gatjo ya mapa xki r'ani, bi kjuat'i ko ngeke nu̱'u ri b'e̱go, ri me̱fi ya ñämfo̱, ra nge'a makjuäni ra hernando cortés ra ndä gabida,"	"Ma dada'ije gra ts'utui, di ne gi pädi ge ma met'o instä tjogije nuna tjogi gatjo ya mapa xki r'ani, bi kjuat'i ko ngeke nu'u ri b'ego, ri mefi ya ñamfo, ra nge'a makjuäni ra Hernando Cortés ra ndä gabida,"
mi b'u̱i ya mu̱dimejai mi ñä ra ndeznä ne jabu̱ ra jnini dige'a gatjo ra nxiki m'onda ngu r'a ya yaqui b'u̱i nuni sonora ne ya maya ri ñ'eje nuni yucatán ra nge bi guat'i ja ra tujni bi nkja nuua m'onda fädi ko ra tjuju ra revolución mexicana ya kje̱ya 1910-1919.	Mi bʉi ya mudimejai mi ñä ra ndeznä ne jabʉ ra jnini dige'a gatjo ra nxiki m'onda ngu r'a ya yaqui bʉi nuni sonora ne ya maya ri ñ'eje nuni yucatán ra nge bi guat'i ja ra tujni bi nkja nuua m'onda fädi ko ra tjuju ra revolución mexicana ya kje̱ya 1910-1919.
mi fo̱tuabi ya ts'u̱tnibo̱kja mi tjutuabi ya jñämfo̱ ra pasadores neje ya bo̱zna ko ya nzafi.	mi hɨtuabi ya ts'ɨtnibɨkja mi tjutuabi ya ñämfo hɨ ra pasadores nehe ya bɨzna ko ya nzafi
"n'a nt'udi di ge'a nuya ntjoki bri t'o̱t'e ja ya jñä ya ndeznä ra ngätsi ra ntjebe nkje̱ya ra r'e̱t'a ma gu̱to (s. xix), r'a ya jnini ngu ra xicontepec (villa juárez) nuna jyodi koji nuni puebla."	"N'a nt'udi di ge'a nuya ntjoki bri t'o̱t'e ja ya jñä ya ndeznä ra ngätsi ra ntjebe nkje̱ya ra r'e̱t'a ma gu̱to (s. XIX), r'a ya jnini ngu ra Xicontepec (Villa Juárez) nuna jyodi koji nuni Puebla."
"n'a ra t'axa dutu mi pe̱tsi ya k'oi ra ixki, nuna mra tjuju jñämfo̱ ""campaneante resonador""."	"n'a ra t'axa dutu mi pe̱tsi ya k'oi ra ixki, nuna mra tjuju jñämfo̱ ""campaneoante resonador""."
"ne ri mpe̱fi ja ra dängan gu nt'udi ra tjuju ra facultad de estudios superiores, acatlán, unam,"	"Ne ri mpʉ̱fi ja ra däŋan gu nt'udi ra tjuju ra Facultad de Estudios Superiores, Acatlán, UNAM,"
"ntjandi gatjo nu'a ra munts'i ra tjuju jñämfo̱ ra globalización ge 'a po̱ts'e dega nest'iji, nuna y'o̱te to̱m'i da nkja ra ntjo̱mäte."	"Ntjandi gatjo nu'a ra munts'i ra tjuju jñämfo ra globalización ge 'a po̱ts'e dega nest'iji, nuna y'o̱te to̱m'i da nkja ra ntjo̱mäte."
"nu'a ma r'a ya kjä'i mi pädi nuña b'e̱fi bri b'e̱pabi xa jyoki yojo ya mpe̱fi mi fädi ko ra tjuju ra amosqueador ko ya xi ya ts'ints'u̱ xi sta jotjo, gi jutsuabi made dige'a n'a ra zänä dega k'astabokja"	"Nü'a ma r'a ya kjä'i mi pädi nüña bëfi bri bëpabi xa jyoki yojo ya mpëfi mi fädi ko ra tjuju ra amosqueador ko ya xi ya ts'ints'u xi sta jotjo, gi jutsuabi made dige'a n'a ra zänä dega k'astabokja"
"nu'a ra munts'a kjä'i bi te̱ni bi zipabi man'a ya b'ede, mi t'ena ge ya kjä'i xki b'u̱i nubu̱ inbi pe̱tsi ra ts'e̱di nu'a mi mä pe m'e̱fa bi kjapi bi nxaxni ya tsu̱tui ne n'a ra diputado mi pe̱tsi ra mfeni xki kot'i mra tjuju ra josé maría lozano, bi y'onga ra jmä pa mar'a ya ñ'oui bi nxanxi: ""ri mo̱te ra tjits'i mi udi ra emiliano zapata, neje bri fädi ngu ra atila nuna bri nkju̱tsi [...] nu'a bi fädi ngu mi je̱gi ya b'e̱go ne'a bi mä da uni da nkja pa gatjo, ingi kjot'i [...]"	"Nü'a ra munts'a kjä'i bi teni bi zipabi man'a ya b'ede, mi t'ena ge ya kjä'i xki b'üi nubü inbi petsi ra ts'edi nü'a mi mä pe m'efa bi kjapi bi nxaxni ya tsütui ne n'a ra diputado mi petsi ra mfeni xki kot'i mra tjuju ra José María Lozano, bi y'onga ra jmä pa mar'a ya ñ'oui bi nxanxi: ""Ri mot'e ra tjits'i mi udi ra Emiliano Zapata, neje bri fädi ngu ra Atila nuna bri nkjüt'si [...] nü'a bi fädi ngu mi je'gi ya b'ego ne'a bi mä da uni da nkja pa gatjo, ingi kjot'i [...]"
nu'u̱ to'o ñä ra ndenzä ja r'e̱t'a ma r'at'o ya estados.	nu'u to'o ñä ra ndenzä ja r'et'a ma r'ato ya Estados.
"nub'u̱ ri m'e̱jni ne ri b'e̱go ya ñämfo̱ bi kjuat'i ko ngekagije ne bi tso̱jo̱ ra gabida ra tjuju ra hernán cortés, maske indi pädije ge gatjo da za da o̱t'e ne xi ra nzunda maría trinidad,"	"Nub'u̱ ri me̱jni ne ri be̱go ya ña̱mfo̱ bi kjuat'i ko ngekagije ne bi tso̱jo̱ ra gabida ra tjuju ra Hernán Cortés, maske indi pa̱dije ge gatjo da za da o̱t'e ne xi ra nzunda María Trinidad,"
"nubia, unga mfädi ja ra ñäjñu kjamädi ra universidad autónoma del estado de hidalgo."	"Nubia, uŋa mfädi ja ra ñäjñu kjamädi ra Universidad Autónoma del Estado de Hidalgo."
"nugi, ra miguel hernández ge di pe̱tsi ma ngu nuni chiyauhtzinco, ko ra t'ek'ei di udi ko nge'i, nuna m'e̱jnant'ofo di joki go tso̱n'i ko nge'i, ma t'ek'ei bo̱najmu'i nda doctor alonso ruiz, ra nk'ojnate ge gi b'ui nuua ja ra jnini ra quamochtitla."	"Nugi, ra Miguel Hernández ge di pe̱tsi ma ngu nuni Chiyauhtzinco, ko ra t'ek'ei di udi ko nge'i, nuna m'ejnant'ofo di joki go tso̱n'i ko nge'i, ma t'ek'ei bo̱najmu'i nda doctor Alonso Ruiz, ra nk'ojnate ge gi b'ui nuua ja ra jnini ra Quamochtitla."
"nuna je̱m'i bri t'unga mfädi ko ra t'u̱ka ntjint'ant'ofo po ra marcelo díaz salas ne ra luis reyes garcía ja: tialtocan, revista de fuentes para el conocimiento de las culturas indígenas de méxico, vol. vi, 1970, b'ede ra 3, pp. 193-212."	"Nuna he̱m'i bri t'unga mfädi ko ra t'u̱ka ntjint'ant'ofo po ra Marcelo Díaz Salas ne ra Luis Reyes García ja: Tialtocan, Revista de Fuentes para el Conocimiento de las Culturas Indígenas de México, Vol. VI, 1970, b'ede ra 3, pp. 193-212."
"nuna jñäpi juts'i ja n'a ra je̱m'i fädi ra derecho canonigo ko ra tjuju jñämfo̱ ngu ra ""solicitación al administrar el sacramento de la confesión""."	"Nuna hñäpi juts'i ja n'a ra he̱m'i fädi ra derecho canonigo ko ra t'huhu hñämpho̱ ngu ra ""solicitación al administrar el sacramento de la confesión""."
"nuna m'e̱jna nt'ofo b'e̱tsi ja ra archivo histórico nacional, madrid, documento 165. bi unga mfädi ja ra nt'ofo ya zubi po ra y'ofo ra tjuju ra arthur j. o. anderson et al.: byond the codices: the nahua view of colonial mexico, berkeley, university of california press, 1976, pp. 181-187."	"Nuna m'éjna nt'òfo b'étsi ja ra Archivo Histórico Nacional, Madrid, documento 165. Bi únga mfädi ja ra nt'òfo ya zubi po ra y'òfo ra tjuju ra Arthur J. O. Anderson et al.: Beyond the Codices: The Nahua View of Colonial Mexico, Berkeley, University of California Press, 1976, pp. 181-187."
"nuna nt'ofo b'e̱tsi ja ra archivo general de indias, sevilla, audiencia de méxico 168, bi unga dra fädi po ra miguel león-portilla ja cultura en peligro, méxico, alianza editorial mexicana, 1976, pp. 102-103."	"Nuna nt'õfo b'ẽtsi ja ra Archivo General de Indias, Sevilla, Audiencia de México 168, bi unga dra fädi po ra Miguel León-Portilla ja Cultura en peligro, México, Alianza Editorial Mexicana, 1976, pp. 102-103."
"nuna pika je̱m'i kja te mä b'e̱tsi ja ra archivo general de la nación, nuua m'onda ne kja ja ra nduntji ya jnini, njabu̱ ngu ya nzaya nuni manjyati ne mar'a ya jnini, o̱t'e gi o̱de ra jñä ra mu̱dimejai."	"Nuna pika je̱m'i kja te mä b'e̱tsi ja ra Archivo General de la Nación, nuua m'onda ne kja ja ra nduntji ya jnini, njabu̱ ngu ya nzaya nuni manjyati ne mar'a ya jnini, o̱t'e gi o̱de ra jñä ra mu̱dimejai."
"nuua t'unga yojo ya jmä, kuän'ajmä ya ndeznä ne tjuts'i ja n'a ra k'oi mä mäkjuäni ri ntje̱ui n'a ya dänga ra tju̱ajmä manteb'u̱, nuua pede nu'a gatjo ya ts'otjogi bi y'o̱t'a dega fete ra alvarado."	"Nüüa t'unga yojo ya jmä, kwän'ajmä ya ndeznä ne tjuts'i ja n'a ra k'oi mä mäkjüani ri ntje̱ui n'a ya dänga ra tju̱ajmä manteb'u, nüüa pede nü'a gatjo ya ts'otjogi bi y'o̱t'a dega fete ra Alvarado."
"nuua ya mu̱di noya ra motolinia, ja ra mu̱di nkoji bi t'o̱t'e ko ra tjuju ra tratado tercero ra dänga b´ede ya mu̱dimejai nuua r´ayo manjyati:"	"Nüüa ya mǘdi noya ra Motolinia, ja ra mǘdi nkʼoji bi tʼǫtʼe ko ra tÿÿu ra Tratado Tercero ra Däŋa Bʼede ya mǘdimejai nüüa rʼayo Manjyati:"
"pa da t'unga mfädi gatjo nu'u̱ bi nkja, n'a di ge'u̱ ko ngu fe̱ti nu'a makjuäni mi joki mi tjutsuabi ya jnei ne ya b'ida. b'u̱i man'a ra mfädi da t'o̱t'a ra nt'udi, nu'a ra tjuju ""fe̱ta nu'a makjuäni bi nja nub'u̱ ra tsokat'o̱tamfeni (teatro de la conquista)""."	"Pa da tʼunga mfädi gatxo nuʼu̱ bi nkxa, nʼa di geʼu̱ ko ngu fe̱ti nuʼa makjuäni mi joki mi txutxuabi ya jnei ne ya bʼida. Bʼu̱i manʼa ra mfädi da tʼo̱tʼa ra ntʼudi, nuʼa ra txuxu ""fe̱ta nuʼa makjuäni bi nxa nubʼu̱ ra txokatʼo̱tamfeni (teatro de la conquista)""."
"ra europa -mra nxika jai manteb'u̱, mi pe̱tsa n'a ra nxika b'ede-"	"ra europa -mra nxika jai manteb'u, mi pe̱tsa n'a ra nxika b'ede-"
"ra fernando ramírez mä ge nuna jyodi ri nge̱pu̱ jabu̱ kja n'a ra nikja ra san fernando ne ra ermita dige'a ya mártires dige'a san hipólito,"	"Ra Fernando Ramírez mä ge nuna jyodi ri ngë̱pü̱ jabü̱ kja n'a ra nikja ra San Fernando ne ra Ermita Dige'a Ya Mártires Dige'a San Hipólito,"
"ra fernando de alva ixtlilxóchitl, fernando de, xiii relación: ""ra ñ'eje ya ñämfo̱ ne ra fu̱di ra nkanfri ra evangelio""."	"Ra Fernando de Alva Ixtlilxóchitl, Fernando de, XIII relación: ""Ra ñ'eje ya ñämfo̱ ne ra fu̱di ra nkanfri ra Evangelio""."
"ra kuän'ajma ra n luz jiménez bi juts'i ra fernando horkasitas bi unga mfädi ne bi r'atsi nuña jmä), de porfirio díaz zapata, memoria nábuatl de milpa alta, méxico, unam,, instituto de investigaciones históricas, 1974, p. 105"	"Ra kwäṉ'ajma ra n luḏz Jiménez bi jut's'i ra Fernando Horkasitas bi uṉga mfädi ne bi r'at's'i nuṉa jmä, De Porfirio Díaz Zapata, Memoria náhuatl de Milpa Alta, México, UNAM, Instituto de Investigaciones Históricas, 1974, p. 105"
"ra raymundo isidro alavez, bi b'u̱i'i nuni ra boxtha chico, san salvador, estado de hidalgo"	"Ra Raymundo Isidro Alavez, bi bʉʉi nuni ra Boxtha Chico, San Salvador, Estado de Hidalgo"
"ra jmä ra fundación de santo tomás ajusco, archivo general de la nación, méxico, ramo de tierras vol. 2676, expediente. 4, archivo histórico de la biblioteca nacional de antropología, colección antigua, vol. 254, fojas 259 r.- 260 v."	"Ra hmä ra Fundación de Santo Tomás Ajusco, Archivo General de la Nación, México, Ramo de Tierras vol. 2676, Expediente 4, Archivo Histórico de la Biblioteca Nacional de Antropología, Colección Antigua, vol. 254, fojas 259 r.- 260 v."
"ra makja mra tjuju ra toribio benavente, motolinia,"	"Ra makya mra tyuyu ra Toribio Benavente, Motolinia,"
"tlauhquechol: ra ts'ints'u̱ xa ntjeni pode ge'a ra flamenco o ra guacamaya, pode ge gatjo ra tje̱nga ts'ints'u̱ ne dänga."	"Tlauhquechol: ra ts'ints'u̱ xa ntjeni pode ge'a ra flamenco o ra guacamaya, pode ge gatjo ra tje̱nga ts'ints'u̱ ne dänga."
"xkri tso̱ngä ngostji, kja jejni ya 'ñu; nä'ä rí ma nxamädo, ja nä'ä rí ma mäbo̱za. antes de"	"xkri tsongä ngostji, kja jejni ya 'ñu; nä'ä rí ma nxamädo, ja nä'ä rí ma mäboza"
"ya b'e̱go ne ya b'e̱tri di ge'a nu'a ra dänga ndä ra ndada ra tjuju ra esteban de guzmán ra nzaya di gekua m'onda, ra ndada ra hernando pimentel, ra ndada ra antonio cortés, ra ndada xuua (juan) nuna ra mecoyoacan, ra ndada pedro motecuhzoma, me ma r'a ya kuänmi (firmas)."	"Ya bʔego ne ya bʔetri di geʔa nuʔa ra däŋga ndä ra ndada ra tjuju ra Esteban de Guzmán ra nzaya di gekua mʔonda, ra ndada ra Hernando Pimentel, ra ndada ra Antonio Cortés, ra ndada xuua (Juan) nuna ra Mecoyoacan, ra ndada Pedro Motecuhzoma, me ma rʔa ya kuänmi (firmas)."
"ya kuän' ajmä xa tjogi manteb'u̱e ge xa tjäst'i nu'a gatjo ra ntjandi to'o bi b'e̱di ge xa pu̱ngajñä nuna jmä getbu̱ n'ate ya jñäki ge ñä ya nso̱jo̱ jñäki ne xa y'oni nuna nt'ofo neje ja ra jñäki yazi xada kjä'i , ge'a nuna jñäki fadi ja ra jñämfo ko ra tjuju ra sistema braile."	"Ya kuän' ajmä xa tjogi manteb'u̱e ge xa tjäst'i nu'a gatjo ra ntjandi to'o bi b'e̱di ge xa pu̱ngajñä nuna jmä getbu̱ n'ate ya jñäki ge ñä ya nso̱jo̱ jñäki ne xa y'oni nuna nt'ofo neje ja ra jñäki yazi xada kjä'i, ge'a nuna jñäki fadi ja ra jñämfo ko ra tjuju ra sistema braille."
"ya r'atsanoya ra sahagán, ndoxkjua k'oi florentino, lib. xii, caps. xxix-xli (versión de ángel ma. garibay k.)."	"Ya r'atsanoya ra sahagán, ndoxkjua k'oi Florentino, Lib. XII, caps. XXIX-XLI (versión de Ángel Ma. Garibay K.)."
despwés ya desde k'a ra momento ya k'a ya jíngi bénya'wi já té bimáju̱ k'a ra charroya'wi	Despwés ya desde k'a ra momento ya k'a ya xíngi béña'wi xá té bimáhu k'a ra charroya'wi
despwés ya xo bimu̱fí pe xo diario diario bu̱ nchúi mitsu̱ k'a ra charro mi'óbí k'a ra mikwála	despwés ya xo bimufí pe xo diario diario bu nchuí mitsu k'a ra charro mi'obí k'a ra mikwála
goparejájé primero 'á k'a ra parte ánk'ú dínant'í	Goparejájé prímero 'á k'a ra parte ánk'ú dínant'í
i asta fecha pues ignoro mucho pero másk'ŭ mäkjámá más ndímáignorajéwi	i asta fecha pues ignoro mucho pero máskŭ mäkjámá más ndímá ignorajéwi
indu̱odiagí bastante	indu̱odiagí báste
"inga se̱je̱ ra nntjandi ra manjyati ne ra portuguesa neje ra francesa, inglesa, alemana e italiana,"	"inga se̱je̱ ra ntjandi ra manjyati ne ra portuguesa neje ra francesa, inglesa, alemana e italiana,"
k'a mädämé para ke mantenigíjé dígotjó mäbäjtsí pues ni modo dísufréjé	k'a mädamé para ke mantenijé digotjo mäbajtsi pues ni modo disufrejé
kómá'u̱té ya fuente níjí	komahnte ya fuente niji
"ne bi unbabi nduntji ya baba, bi enbabi ge mi ne da ñäui ra ndä (emperador) mi b'u̱i nuni manjyati, ne da jäni ra dänga ts'ofo ra evangelio,"	"Ne bi umbabi nduntji ya baba, bi enbabi ge mi ne da ñäui ra ndä (emperador) mi b'ui nuni manjyati, ne da jäni ra dänga ts'ofu ra evangelio,"
normalmente gójo	normalmente gójo
panteón ga dó	Panteón ga dó
pero de sesenta pantsítjá pa gotjók'ŭ kompletamente xatjó ndímáfădijé	pero de sesenta pantsitja pa gotjok'u kompletamente xatjo ndimafadije
pero eso sí binújgí mängŭjé kada ná	pero eso sí binúhgí mängüjé kada ná
"po nuya kja'i to'o mi pede ge fädi ko ra tjuju ya ""cronistas de las indias”"	"po nuya kjai too mi pede ge faadi ko ra tjiju ya ""cronistas de las indias”"
pues este kábádá balewa este mínimo siento sinkwenta	pues este kabada balewa este minimo siento sinkuenta
pues nimodo bisufré k'a más ante mäabwelitajé komo mbu̱i enkajoso ra ntsoya	pues nimodo bisufré k'a más ante maa bwelitajé komo mbui enkajoso ra ntsoya
"ra nku̱t'i ra juajni ne ya ñ'udi ntjutsi ra agustin yáñez 2da. edición. biblioteca del estudiante universitario, unam, 1950."	"Ra nkʉ̱tʼi ra hua̱jni ne ya ɲʉdi ntjutʃi ra Agustín Yáñez. 2da edición. Biblioteca del Estudiante Universitario, UNAM, 1950."
solamente ya riko alkansabi	solamente ya rïk'o alkansabi
xi ra tí na ta komedór 'á itsí na ta alimento k'a ra ndăni	Xi ra tí na ta komedor 'á itsí na ta alimento k'a ra ndani
xo mitajá ra ntsoya mitá sínko pesos ra béjña dos sinkwenta	Xo mitajá ra ntsoya mitá síngko pesos ra béjña dos siékwaenta
xo takja mä sesenta wik'a takja mä sesenta bitajkíjéya'wik'a	Xo takya mä sesenta hwi'ka takya mä sesenta bitaxkíye'ya'hwi'ka
á panteón ga dó níjí	á pantéon ga dó níjí
ñúdigejña dabadijíya' razo''ya' mientra más dandu̱jté	ñudigejña dabadijíya' razó''ya' mientra máj dandu̱jté
"-nu'u̱ dige'u̱ b'u̱i nuni maxey (tolimán ne amealco), dige'u̱ temoaya nuni ra ra jyodi estado de méxico ne mar'a ya jyodi nuni puebla ne veracruz"	"Nu'u digeu bui nuni maxei (Tolimán ne Amealco), digeu Temoaya nuni ra ra jyodi Estado de México ne mar'a ya jyodi nuni Puebla ne Veracruz"
"ne mätajekitjo di kja getbu̱, ra jñäpi ra joel martinez hernández ne ra jotjo tjuajmä ra natalio hernández xocoyotzin, nuya yojo ya xajnate ri ñ'eje ya y'u̱ dige'u̱ ya ndeznä."	"Ne mäṭajekijo di kja geṭbũ, ra jñäpi ra joel martinez hernández ne ra jotjo tjuajmä ra natalio hernández xocoyotzin, nuya yojo ya xajnate ri ñ'eje ya y'ũ dige'ũ ya ndeznä."
"-n'ate pa n'a ra zänä de ra r'e̱t'a ma jñäto ""zänä"" mi zo̱ta ya munts'i ya n'ate ya pa ge mi joki ra xihuitl o ""ra m'ede ra kje̱ya"""	"N'ate pa n'a ra tsänä de ra r'e̱ta ma ñäto ""tsänä"" mi tsota ya munts'i ya n'ate ya pa ge mi joki ra sihui tl o ""ra m'ede ra kye̱ya"""
bi ma di gepu̱ jam''u̱ ra ngo pa da ts'itje ya it'adeje (Tlahuano) ba po̱ni nubu̱ tlapechhuan. mra ngo ra izcalli.	bi ma di gepṍ jamʔṍ ra ŋo pa da tsʼitje ya itʼadeje (Tlahuano) ba poṇi nubṍ tlapechhuan. mra ŋo ra izcalli.
bi mu̱di da jyoka ya t'u̱kats'u̱fabo̱kja. ge'a ra ntujni bi nkja nuni Coyohuehuetzin ne ma gojo ba nkja.	Bi mu̱di da jyoka ya t'u̱kats'u̱phabo̱kja. Ge'a ra ntuxni bi nkja nuni Coyohuehuetzin ne ma gojo ba nkja.
"bri tjo ra cuauhnochtli, ra gabida tlacatecco, ra cuapan, ra gabida huitznáhuac, ra makja Amantlan, ne ra makja tlacopan."	"bri tjo ra cuauhnochtli, ra gabida tlacatecco, ra cuapan, ra gabida huitznáhuac, ra makja Amantlan, ne ra makja tlacopan."
bri ts'u̱tuabi ja ra y'u̱ga n'a ra nto̱de dega t'u̱ka joga do dega chalchihuite: made mi juts'i n'a ra tsant'i dega k'astabokja.	Bri ts'utuabi ja ra y'uga n'a ra ntode dega t'uka joga do dega chalchihuite: made mi juts'i n'a ra tsanti dega k'astabokja.
"Castañeda, ra t'u ra Aquiyahualcatecuhtli, m ra ndä nuni tlaxcala."	"Castañeda, ra t'u ra Aquiyahualcatecuhtli, m ra ndä nuni Tlaxcala."
Coaíhuitl mra gabida ndeznä nuya mapa digeá ra t'o̱t'ats' okamfeni.	Coaihuitl mra gabida ndeznä nuya mapa digea ra tohtatsʼ okamfeni
di gepu̱ ba koi pa nuni ra Xochimilco. nubu̱ ba tu ya kjä'i ya metlatelolco	di gepũ ba koi pa nuni ra Xochimilco. nubũ ba tu ya kjä'i ya Metlatelolco
"ebu̱ ba eje man'aki ba te̱nga ra t'o̱jo̱ ra tjuju ra Citlaltépec. Tlacopan, nubia ba o̱t'ra b'u̱i ja ra ndo̱m'ijmu."	"Ebu̱ ba ehe man'aki ba te̱nga ra t'o̱jo̱ ra tjuju ra Citlaltépec. Tlacopan, nubia ba o̱t'ra b'u̱i xa ra ndo̱m'ijmu."
ebu̱ bi dädi ra Cihuacóatl:	Ebu̱ bi dädi ra Cihuacóatl
ebu̱ bi ñä ra Cuauhtémoc bi xipabi ra Cihuacóatl:	Ebu̱ bi ñä ra Cuauhtémoc bi xipabi ra Cihuacóatl
"gojo n'ate ya pa ne ebu̱ bi yopa bo̱ni pa di mani ra Huaxtepec, ra Cuauhnahuac (Cuernavaca)."	"gojo n'ate ya pa ne ebũ bi yopa bõni pa di mani ra Huaxtepec, ra Cuauhnahuac (Cuernavaca)."
"gue dá nhuat'i mbo kja ra ximjai,"	"gue dá ñuat'i mbo kja ra shimjai,"
"i nte ra nge'a, ya jmä juts'i ja ra ndäxkjua k'oi ra códice ra ramírez uni nuna b'e̱de mä makjuäni ngu mä ra ntje̱ka b'ede ne ra ndädi nu'a ra nänä mra tjuju ra yacotzin, ra nänä ra ixtlilxóchitl,"	"i ntera ngē'a, ya hmä juts'i ja ra ndāxkjua k'oi ra códice ra ramírez uni nuna b'ēde mä makjuāni ngu mä ra ntjēka b'ede ne ra ndādi nu'a ra nānā mra tjūju ra yacotzin, ra nānā ra ixtlilxóchitl,"
"inda jyo ko ra ndäxjua ixtlilxóchtil, ra dada ra Nezahualcóyotl ni ko ra fernando de alva ixtlilxóchitl."	"inda jyo ko ra ndäxjua ixtlilxóchtil, ra dada ra Nezahualcóyotl ni ko ra Fernando de Alva Ixtlilxóchitl."
"k o ya bu̱' bai, ko ya makahuai,"	"kʉ ya bʉ̱ʔ bai, kʉ ya makahuai,"
"mi fudi da t'axka ra xudi ba ts'i, bri tját'a ja n'a ra za mi b'ai ja ra ngu ra Ahuizotzin nuni ra Acatliyacapan."	"mi hudi da t'axka ra xudi ba ts'i, bri tját'a ja n'a ra za mi b'ai ja ra ngu ra Ahuizotzin nuni ra Acatliyacapan."
mi gu̱t'a ra ñ'u̱ n'a ra makja ge'a mra b'e̱fi mi zu nu'a ra mäka jai mra tjuju ra Yohualichan.	mi ht'a ra ñ'u na ra makya ge'a mra befi mi zu nu'a ra maka jai mra tjuju ra Yohualichan.
"mi y'o y'oua, mi tuts'i ya bu̱'bai dega za, ne r'a mi jä dega bo̱ja ne ya mahuai."	"mi yʌ yʌua, mi tuhci ya bu̱ʌbai dega za, ne rʌ mi jä dega bo̱ja ne ya mahuai."
mra ngu ra Aztautzin ge'a mi kja getbu̱ nuni ra Amáxac.	Mra ngu ra Aztautzin ge'a mi kja getbṹ nuni ra Amáxac.
n'a ra jyo ne man'a bi xokuabi ra debi. ra Cuauhtemoctzin bri xokuabi ra debi ge'a se̱je̱.	N'a ra ʒyo ne man'a bi xokuaβi ra devi. Ra Cuauhtemoctzin bri xokuaβi ra devi ge'a seʔe.
"ne m'e̱fa bi ma xki jäki ya je dega magabi, ñätsi bi ntsaya ra mahuai ne ra bu̱'bai, bri nkjonda ya bo̱najmu nuni Acachinanco."	"Ne m'efa bi ma xki jäki ya je dega magabi, ñätsi bi ntsaya ra mahuai ne ra bu'bai, bri nkjonda ya bonajmu nuni Acachinanco."
"ne nkjabu̱ bri t'ot'e neje ko mar'a ya bo̱najmu mi pe̱tsi ra t'u̱ka tsu̱tui ja ya t'u̱ka jnini, nuyu̱ to'o mi b'e̱pi da t'o̱t'e ngu nuni Xalapan, Tlaxcalan, Tehuantepec, Oaxaca neje mar'a ya bo̱najmu mar'a ya t'u̱ka jnini jabu̱ bi guat'i ya nduste, ya dumantjuju dega k'astaboja, ge ya tjuju ya kristiano [...]"	"ne nkjabu̱ bri t'ote neje ko mar'a ya bonajmu mi petsi ra tu̱ka tsutui ja ya tu̱ka jnini, nuyu̱ to'o mi be̱pi da tote ngu nuni Xalapan, Tlaxcalan, Tehuantepec, Oaxaca neje mar'a ya bonajmu mar'a ya tu̱ka jnini jabu̱ bi guati ya nduste, ya dumantjuju dega k'astaboja, ge ya tjuju ya kristiano [...]"
"ne nu'a ri däme, pu̱ ñ'a'i, nugi ga ma ga tsogi'i nuni Cuetlachcoapan [n'a ra jnini nuni puebla],"	"ne nu'a ri däme, pu̱ ñ'a'i, nugi ga ma ga tsogi'i nuni Cuetlaxcoapan [n'a ra jnini nuni Puebla],"
"ne nu'u̱ bi mani dra ts'okat'o̱t'amfeni nuni Michoacán, Xalisco, Culhuacan ne nuni neje Pánuco, ne nuni Oaxaca, Tehuantepec ne Guatemala, ne nuua ra r'ayo majyati, nub'u̱ bri t'o̱t'a ra mabagi pa dra uadi dra t'o̱t'a nu'a ra ts'okat'o̱t'amfeni inda tsogije se̱je̱."	"Ne nu'u̱ bi mani dra ts'okat'o̱t'amfeni nuni Michoacán, Xalisco, Culhuacán ne nuni neje Pánuco, ne nuni Oaxaca, Tehuantepec ne Guatemala, ne nuua ra r'ayo majyati, nub'u̱ bri t'o̱t'a ra mabagi pa dra uadi dra t'o̱t'a nu'a ra ts'okat'o̱t'amfeni inda tsogiye se̱ye̱."
"nejege'a ra ngätsi. mi jä ya mpe̱fi dega mabagi,ya nkjom'a te ne ya fu̱nbo̱kja, inte ma mahuai mi jä ni ge'a ya bu'bai."	"Nehege'a ra ngätsi. Mi jä ya mpe̱fi dega mabagi, ya nkjom'a te ne ya fu̱nbo̱kja, inte ma mahuai mi jä ni ge'a ya bu'bai."
njabu̱ bi bo̱nga dega xui. mra ngo nub'u̱ ra Tecuílhuitl bi bo̱nga: nub'u̱ bi kja ya du ja ra r'ani ra deje ya u̱erna.	Njabu̱ bi bo̱nga dega xui. Mra ngo nub'u̱ ra Tecuílhuitl bi bo̱nga: nub'u̱ bi kja ya du ja ra r'ani ra deje ya u̱erna.
"nub'u̱ bi tjandi ra Tzihuacpopoca, bi t'ena:"	"nub'u̱ bi txandi ra Tzihuacpopoca, bi t'ena:"
"nub'u̱ ya ñämfo̱ bi jandi ge xa ñ'eje nubu̱ da tsu̱di, ge mi tekuabi ra nest'iji, m'estjo bi munts'i bi miji ya mahuai."	"Nübʉ ya ŋämpho bi jandi ge xa ŋ'eje nubʉ da tsʉdi, ge mi tekuali ra nestʉiji, mʉestjo bi muntsʉi bi miji ya mahuali."
"nuna kjä'i inbi tsa bi tjädi makjuäni nu'a ra nt'ani. ingra nge'a nuya pa bi jneki n'a ra jyoya jä'i ra macehual (hombre de pueblo),"	Nuna kjä'i inbi tsa bi tjädi makjuäni nu'a ra nt'ani. Ingla nge'a nuya pa bi jneki n'a ra jyoya jä'i ra macehual (hombre de pueblo)
"nuna nte̱nga b'ede ja bri jat'i ra Tzihuacpopocatzin, bi o̱t'e da tjogi ge'a ra ts'e̱y'e̱jmu. inbi bo̱nga nuna nt'o̱t'e bi tsu̱diju̱ ko ma r'a ya b'e̱jni. ma ra ya ñ'ete inbi jopi da kju̱ man'aki ra ñ'u nuya ts'okate. pe nuya inbi joki ra b'ai."	"Nuna ntēnga b'ede ja bri jat'i ra Tzihuacpopocatzin, bi ōt'e da tjogi ge'a ra ts'ēy'ējmu. Inbi bōnga nuna nt'ōt'e bi tsūdiju ko ma r'a ya b'ējni. Ma ra ya ñ'ete inbi jopi da kju man'aki ra ñ'u nuya ts'okate. Pe nuya inbi joki ra b'ai."
"nuua di udije ra jñäpi bi nto̱t'e bi nkja ra agosto ra kje̱ya 1595, n'a ra kjä'i mra tjuju ra miguel Hernández, ra me Chiyauhtzinco,"	"Nuua di udihe ra ñäpi bi nto̱t'e bi nkya ra Agosto ra kye̱ya 1595, n'a ra kyä'i mra tyuju ra Miguel Hernández, ra me Chiyauhtzinco,"
nuya bo̱najmu ya mem'onda ñätsi bi ñäui ra Cihuacóatl Tlacotzin m'estjo bi tjädi:	Nuya boñajmu ya mem'onda ñätsi bi ñäui ra Cihuacóatl Tlacotzin m'estjo bi tjädi
ra Tlacatécatl mra me Cuauhtitlan ne ra bktri ra mbot'a ngu bri kjapi ya tsat'yo bi zi.	ra Tlakatekatl mra me Kuauhtitlan ne ra paktri ra mbota ngu bri kjapi ya tsatyo bi zi
ra doy'e̱ pajni xki njom'i ko ya chalchihuite.	Ra doy'e̱ pajni xki njom'i ko ya chalchihuite.
"ra mu̱di ra Cuauhtémoc, ra jmu ra bondo, ra nyojo ra tlatsotzin, ra Cihuacóatl ra njñu ra oquiztzin, ra bo̱najmu ja ra nini ra aztsapotzaltso Mexicapan, ra ngojo ra panitzin, ra bo̱najmu nuni ra Ecatepec,"	"Ra mu̱di ra Cuauhtémoc, ra hmu ra bondo, ra ñojo ra tlatsotzin, ra Cihuacóatl ra ñĩu ra oquiztzin, ra bo̱naxmu xa ra nini ra aztsapotzaltso Mexicapan, ra ngojo ra panitzin, ra bo̱naxmu nuni ra Ecatepec,"
"ra mu̱di ra pa mi o̱t'e ra ngo ra mäkime ra u, ra tjuju ra Huixtocihuatl"	"ra mu̱di ra pa mi o̱t'e ra ngo ra mäkime ra u, ra tjuju ra Wiixtociahual"
ra nge'a bi mu̱ni ko ra mahuai ja ra xu̱tja nu'a to'o bi umbabi ra kji.	ra ngë'a bi muni ko ra mahui ja ra xutja nu'a to'o bi umbabi ra kji
"ra nyojo, bi tjo ra ndä ra Nauhtla, mra tjuju ra Cohualpopocatzin."	"ra ñojo, bi tjo ra ndä ra Nauhtla, mra tjuju ra Cohualpopocatzin."
"unga ya ngue̱nda te ra ts'omu̱i mi bu̱'i ne mi kjapi da ntso̱m'i nuya macehualtin, nkjabu̱ mi tjutuabi ya kjä'i mi b'u̱i te ma za"	"Ŋga ya ŋge̱nda te ra c'omu̱i mi bʉ̱'i ne mi kjapi da ncʉ̱m'i nuya macehualtin, nkjabʉ̱ mi cjutuabi ya kjä'i mi bʉ̱'i te ma za"
"xib'u̱ bri fádi ge nuya je mi kja nuni ra Cuauhchichilco, ja Xaltocan; ge mi pttsi ya ndá."	"xib'u̱ bri fadi ge nuya je mi kja nuni ra Cuauhchichilco, ja Xaltocan; ge mi ptsi ya nda."
"xki mbo̱ni nubu̱ ra jyodi ra Cuehuecatitlan,"	"xki mbøni nubø ra jyodi ra Cuehuecatitlan,"
"xki tjete ra ixtlilxóchitl ne ra ku ra Cohuanacotzin ko ya je dega dänga ndä bi mu̱di da jäni ra joga ts'ofo ya evangelio,"	xki tjete ra ixtlilxóchitl ne ra ku ra Cohuanacotzin ko ya je dega dänga ndä bi mu̱di da jäni ra joga ts'ofo ya evangelio
"ya dänga ñu̱ni nsafi, ya nsafi, ya mahuai, jangu nu'u̱ gatjo xki tagi mbo ja ra jñe."	"Ya däŋga ñuni nsahi, ya nsahi, ya mahuai, jangu nu'u gatyo xki tagi mbo ja ra ňe."
"bi o̱tuabi nu'a ra makja xki nk'ojni mra tjuju ra alonso ruiz, ge mi y'o nuni juamuxtitan (Huamuxtitlan) nuni ra jyodi guerrero."	"Bi o̱tuabi nu'a ra makya xki nk'ojni mra tjuju ra Alonso Ruiz, ge mi y'o nuni Juamuxtitan (Huamuxtitlán) nuni ra jyodi Guerrero."
"di pädi xajño nuna b'e̱fi neje yojo to'o di pädi da mpe̱fi da y'este nuya joga do majye̱gi ya xito, mra tjuju ra ambetz'ihuay."	"di pädi xajño nuna b'ëfi neje yojo to'o di pädi da mpëfi da y'ëste nuya joga do majyëgi ya xito, mra tjuju ra ambëtz'ihuay."
"dra tjoki ra nto̱de, ra ketzal dra b'e̱ nuni Coyohuacan."	"Dra tjóki ra ntóde, ra kétzal dra b'e̱ nuni Coyohuacan."
e mi r'ani dega xui ra Cihuacóatl g'ea mi zoni ne mı mafi.	e mi rʼani dega xui ra Cihuacóatl gʼea mi zoni ne mı̄ mafi
"ebu̱ bi gäi jabu̱ mi to̱ge ebu̱ bi yopa ma ja ra jnini ra Cuetaxtlan,"	"Ebu̱ bi gäi jabu̱ mi to̱ge ebu̱ bi yopa ma ja ra jnini ra Kuetaxtlan,"
"ge'a ra mu̱di ra tjuju ra Hernando, ra nge'a nkjabu̱ mra tjuju ra takjä ra Cortés neje nkjabu̱ mra tjuju ra ndä Católico ne ra ku ra Cohuanacotzin bi tjutuabi ra Pedro po ra Pedro Alvarado ra nge'a ra takjä,"	"He'a ra mudi ra tyuhyu ra Hernando, ra nge'a nkjabu mra tyuhyu ra takye ra Cortés neje nkjabu mra tyuhyu ra nda Católico ne ra ku ra Cohuanacotzin bi tyutuabi ra Pedro po ra Pedro Alvarado ra nge'a ra takye,"
"ma n'a mi b'ai nuni teotletso, jabu̱ ra ñ'u̱ pa manjuäntjo pa da zo̱ni nuni ra peñón (Tepetzinco)."	"ma n'a mi b'ai nuni teotletso, jabu̱ ra ñ'u̱ pa manjuäntjo pa da zo̱ni nuni ra peñón (Tepetzintli)"
"mi tso̱jo̱ getbu̱ ra fu̱nga t'o̱jo̱, jabu̱ mi tjutuabi ""takjón ra nxu̱ni, nkjabu̱ bi jutuabi ya ndeznä ya b'e̱jnanoya bi pe̱jni ra ts'e̱y'e̱jmu, mi gu̱t'a ra ñ'u ra Tzihuacpopocatzin, bi bo̱nga ja ra ñ'u."	"mi tsõhõ getbũ ra fũnga t'õhõ, jabũ mi tjutuabi ""takjón ra nxũni, nkjabũ bi jutuabi ya ndeznä ya b'ejnanoya bi pejni ra ts'ejemũ, mi gũt'a ra ñ'u ra Tzihuacpopocatzin, bi bõnga ja ra ñ'u."
mra ku ra Cacamatzin mra bo̱najmu nuni Tetzcoco mri ñ'oui va kjä'i mi y'o mpaja.	Mra ku ra Cacamatzin mra bo̱najmu nuni Tetzcoco mri ñ'ui va kjä'i mi y'o mpaja.
"n'a ra nto̱de dega chalchihuite, xi m'et'e dega ze̱ka do, neje mi pe̱tsi n'a ra tsant'i de ga k'astabokja."	"N'a ra ntōde dega chalchihuite, xi m'et'e dega zēka do, neje mi pētsi n'a ra tsanti de ga k'astabokja."
ne nduntji ya ambetz'ihuay ne mar'a joga do mi pe̱tsi ra mu'ui:	Ne ndũtĩ ya ambec'ihua ne mar'a joga do mi pe̱cĩ ra mu'ui:
neje n'a ya tje̱stji dega mboťahuaido.	Nehe n'a ya tyestxi dega mbot'ahuaido.
"nuna bi o̱t'a ra ntso̱m'i ra nge'a neje nuya ya b'e̱datsi bi tsini ko ra Cortés ne ra Cohuanacotzin ne ra ixtlilxóchitl xki nsofo pa ra ixtlilxóchitl da gu̱ka ya kjä'i ge mi zu ya jyodi, nkjabu̱ mi pe̱jna akjuä da t'o̱t'e."	"Nuna bi o̱t'a ra ntso̱m'i ra nge'a neje nuya ya b'e̱datsi bi tsini ko ra Cortés ne ra Cohuanacotzin ne ra ixtlilxóchitl xki nsofo pa ra ixtlilxóchitl da gu̱ka ya kjä'i ge mi zu ya jyodi, nkjabu̱ mi pe̱jna akjuä da t'o̱t'e."
"nuna nt'o̱t'e bi ntjandi xa nts'ogi njabu̱ bri tjutuabi, bi ena ge mra nzu̱te ko ma m'u̱jai ra nzu̱te ne mi tjutsuabi ko ya mpe̱bi dega mabagì, jabu̱ jmä ge n'a di ge'u̱ bi y'e̱nga n'a ra do, ko nge'a bi jyo, nu'u̱ mar'a ya b'e̱go ge mä ge nu'u̱ se̱je̱ ya ñämfo̱ bi jyo bi mu̱tu'a n'a ra mahuai ja ri ngati bi mu̱tuabi n'a ra nzu̱ni."	"Nuna nt'o̱hte bi ntjandi xa nts'ogi njabu̱ bri tjutuabi, bi ena ge mra nzu̱hte ko ma m'u̱jai ra nzu̱hte ne mi tjutsuabi ko ya mpe̱bi dega mabagi, jabu̱ jma̱ ge n'a di ge'u̱ bi ye̱nga n'a ra do, ko nge'a bi jyo, nu'u̱ mar'a ya be̱go ge ma̱ ge nu'u̱ se̱je̱ ya ña̱mfo̱ bi jyo bi mu̱tu'a n'a ra mahuai ja ri ngati bi mu̱tuabi n'a ra nzu̱ni."
"ra Cuauhtémoc, Tlacotzin, ra Cihuacóatl, Oquiztzin, Panitzin, Motelhuihtzin; nuna bi sofo ra tsortés nuni Coyoacan, nu'u̱ to'o mi pädi yojo ya jñäki ngu'a ra jerónimo aguilar ra malintzin."	"ra Cuauhtémoc, Tlacotzin, ra Cihuacóatl, Oquiztzin, Panitzin, Motelhuihtzin; nuna bi sofo ra tsorés nuni Coyoacan, nu'u̱ to'o mi pädi yojo ya ñäki ngu'a ra Jerónimo Aguilar ra Malintzin."
t'ena ge ya macehual [ya kjä'i b'u̱i ja ra jyoya]	tʔena ge ya masehual [ya kjä'i bʉi ja ra ʒjoja]
"xki tjokuabi nuya jotjo ts'ints'u̱ mra tjuju ra ""tlauhquecho"" ne “tzinitzcan zacuan"","	"xki tjokuabi nuya jotjo ts'ints'u mra tjuju ra ""tlauhquecho"" ne “tzinitzcan zacuan”"
-¿te be'a gi mä nu'i Cihuacóatl?	-¿te be'a gi mä nü'i Cihuacóatl?
"bi k'ajni ko ya dänga ñuni nzafi ne bi tjetse ko ya makahuai nuya otomi geb'u̱ bi japi bi b'e̱di, bi mä nuyu̱:"	"Bi k'ajni ko ya dänga ñuni nzafi ne bi tjetse ko ya makahuai nuya Otomi geb'u bi japi bi b'edi, bi mä nuyu"
da tjuts'i ya nkjot'ijñä ( )	dá tsuts'i ya nkjot'íñä
"da umbabije te da zi, da kjapabije nduntji ma zu."	"dá ūmbabíje te dá zí, dá kjapabíje ndūntji ma zū."
ebu̱ bi mä nuna b'e̱fi xa tjoki xajño bi kjohya ra ts'e̱y'e̱jmu.	Ebu̱ bi má nuna b'e̱fi xa tjoqui xajño bi qujya ra ts'e̱y'e̱mju.
"fernando alva ixtlilxóchitl, xiii nkjändajmä ""ra ñ'eje ya ñämfo̱ ne ra mu̱di ra joga ts'ofo ra evangelio."""	"Fernando Alva Ixtlilxóchitl, XIII nkjändajmä ""ra ñ'eje ya ñämfo̱ ne ra mu̱di ra joga ts'ofo ra Evangelio."""
"ga kjuatiju̱ nu'a juts'i nkjani, ya ts'ojä'i, ra carranza, ge xa o̱t'a ya ts'okuate pa gekagiju̱; ga o̱t'e da nkja ra ts'e̱di ma munts' ne njabu̱ ga tsu̱diju̱ da nkja nu'a ra joga tsu̱tui, da nkja ra jai, ra jñegi ne ra joga ts'u̱tui;"	"Ka kjuatihu nu'a juts'i nkjani, ya ts'ojä'i, ra Carranza, ge xa ota ya ts'okuate pa gekagiju; ka ote da nkja ra ts'edi ma munts' ne njabu ga tsudi ju da nkja nu'a ra joga tsutui, da nkja ra jai, ra jñegi ne ra joga ts'utui;"
gatjo ya jyoyakjä'i mi b'u̱i ja ra jnini bi jandi.	Gatyo ya joyakjä'i mi bʉi ja ra jnini bi jandi.
"ja bi jäni ra ñ'udi, ma kjä'iju̱ bi ent'i gatjo majye̱gi nuya nzu̱te"	"Ja bi jäni ra ñudi, ma kjä'iju bi ent'i gatyo majyegi nuya nzute"
"ja n'aa nza̱tjo xudi ra pale berto, bi bo̱ni nda jyonga te nda nzimxidi ngetjo nda zi ya jme jyaxtjo mi u̱xa ya u, ua ngu mi nzäi mi nkajui yá jme nuya chukju̱ xa jogi ja nuya 'bomuja̱i nts'ät'i, nt'o̱kuä;"	"Ja nʼaa nzatyo xudi ra pale Berto, bi boni nda jyonga te nda nzimxidi ngetyo nda zi ya jme jyaxtjo mi uxa ya u, ua ngu mi nzäi mi nkajui yá jme nuya chukju xa jogi ja nuya 'bomuja̱i ntsʼatʼi, ntʼokuä;"
"ja nubia di ndäki, di ndändiñäjmu, di ma ga ts'u̱tsa'i ri y'e, ga ndäne'i ra nge'a nu'a'i ma makjaje, ra bartolomé lópez, nub'u̱ mi nkjuäni ma b'e̱jña inbi nkjuäni ja nubu̱ mi xaxi pa da o̱t'a ya tso̱mfen"	"Ja Nubia di ndäki, di ndändiñäjmu, di ma ga ts'u̱tsa'i ri y'e, ga ndäne'i ra nge'a nu'a'i ma makjaje, ra Bartolomé López, nub'u̱ mi nkjuäni ma b'e̱jña inbi nkjuäni ja nubu̱ mi xaxi pa da o̱t'a ya tso̱mfen"
"ja ya t'u̱ka ze̱ki tjuts'i n'a tu̱kitjo nuna tjogi ge bi juxa ra fernando alva ixtlilxóchitl, nu'a b'e̱tsi ra xiiii nkjondajmä."	"Ya ɨtʉ̱ka zɛ̱ki tʃutʃʼi nʼa tʉ̱kitʃo nuna tʃogi ge bi ʃuxa ra Fernando Alva Ixtlilxóchitl, nuʼa bʼɛ̱tʃi ra xiiii nkʲondaʃmä."
jabu̱ ga kju̱he nuyu̱ (ya tenochcas) te gi joniju̱?	jabṵ ga kjṵhe nṵyṵ (ya tenochcas) te gi jonijṵ?
"jam'u̱ gatjo ya kjuän'ajmä ge nuua xa ze̱ti ri ñ'eje dige'a ya noya ya mu̱dimejai ja ra jñä ya ndeznä, nuna tjuju ri uni inga se̱je̱ ra n'atsanoya pa da fädi ra jñämfo̱, ingi ri me̱udi dige'a ra jmä fu̱oti dige'a nuna ra jñäki ra netzajualtsoyotl. ne ra cuauhtémoc."	"Jamʉ̱ gatxo ya kyuänʼaxmä ge nuua xa zeti ri ñʼehe digeʼa ya noya ya mudimejai xa ra jñä ya ndeznä, nuna txuxu ri uni inga sehe ra nʼatsanoya pa da fädi ra jñämfo, ingi ri meudi digeʼa ra jmä fuoti digeʼa nuna ra jñäki ra netzajualtsoyotl. Ne ra Cuauhtémoc."
mi jneki ngu ma kjä'iju̱ ngabu̱ mri jneki.	mi ñeki ngu ma kjä'ju ngabu mri ñeki.
"nduntji bri kjojya, bri tjuxpabi gatjo nu'a mi o̱t'abi ra b'edi, ko nge'u̱ bi m'u̱i ne mi t'umbabi ya t'ixu:"	"Ndũñti bri kjoja, bri tjuxpabi gatjo nu'a mi o̱t'abi ra b'edi, ko nge'u̱ bi m'u̱i ne mi t'ũmbabi ya t'ixu:"
"ngu mra me̱ti, nu'a r'a hyodi, jabu mi y'o, n'a ngu n'a mi kjohya mi mfe̱m'a xinxi xi mi kjohya ya ndäte, mi tjede n'a ngu n'a mi jñu̱fi ne mi fe̱m'a ya xinxi: xi mi b'u̱i mpaja."	"Ngu mra me̱ti, nu'a r'a jyodi, jabu mi y'o, n'a ngu n'a mi kjohya mi mfe̱m'a shinshi xi mi kjohya ya ndäte, mi tjede n'a ngu n'a mi ñu̱fi ne mi fe̱m'a ya shinshi: xi mi b'u̱i mpaha."
"nkjabu̱ ri ñ'eje ya kje̱ya inda m'e̱di, inda mpumfri, ga nzäi ga pe̱tsi nugagiju̱ ja ma mfeniju̱, ga pe̱tsi nugagiju̱, ra bätsi dige'u̱, ya b'e̱to, ya ntsaniku, ya mbänga b'e̱to ne to'o dra ñ'epu̱, to'o majye̱gigiju̱, ma kjiju̱, ya ku̱ju̱."	"Nkjabu̱ ri ñ'eje ya kje̱ya inda m'e̱di, inda mpumfri, ga nzäi ga pe̱tsi nugagiju̱ ja ma mfeniju̱, ga pe̱tsi nugagiju̱, ra bätsi dige'u̱, ya b'e̱to, ya ntsaniku, ya mbänga b'e̱to ne to'o dra ñ'epu̱, to'o majye̱gigiju̱, ma kjiju̱, ya ku̱ju̱."
"nu xä otj'u̱, ma gä ñ'kjäju̱"	"nu hña otxu, ma gä nkjaju"
"nuga̱ xi di ne'i, jindi pädi jankja..."	"Nuga̱ xi di ne'i, jindi pädi yankja..."
"num'u̱ di kjojyaju̱, nkueju̱, nts'o̱miju̱, tsuju ne pa da t'o̱xkäju̱ di jojñu̱ nu ya nt'u̱i xi di 'yooju̱ (¡!). nuya da nt'ot'i ko ra dänt'ot'í"	"numʉ̱ di kjojyaju̱, nkueju̱, ntsʼomi̱ju̱, tsu̱ju ne pa da tʼo̱xkäju̱ di jojñu̱ nu ya ntʉ̱i xi di ʼyooju̱ (!). nuʉya da ntʼotʼi ko ra däntʼotʼi"
"nuna bi kjojya ja ra mabagi,"	"nuna bi kjòjyà jà rà mbàgì,"
"nuya jñu o gojoya pa bi b'u̱i nubu̱ bi xitsuabi ra kjäpadeje nduntji ya kjä'i, ngu xa t'ena."	"Nuya jñu o gojoya pa bi bʼui nubuʼ bi xitsuaʼbi ra kjäpadeje nduntji ya kjäʼi, ngu xa tʼena."
"nuya tsat'io mi b'et'o, mi gu̱t'a ra ñ'u, mi teni, ya xiñu mi kju̱ts'i pa mañä, xi mi päjä gatjo mi jandi mi nest'iji: mi tu̱ta ya kjijni"	"Nuya tsat'io mi b'eto, mi gu̱t'a ra ñ'u, mi teni, ya xiñu mi kju̱ts'i pa maña, xi mi päjä gatyo mi jandi mi nest'iji: mi tu̱ta ya kijni"
"pe, nu'i ndada nu'i ma t'ek'ei ra makja, nub'u̱ nu'i ingi zugagije, ¿jankja, nuua, ra jyo di ge'a, ga tsogi nubu̱ [nu'a ma b'e̱jña]?"	"pe, nu'i ndada nu'i ma t'ek'ei ra makxa, nub'u nu'i ingi zugaxiye, ¿yankxa, nuua, ra xyó di ge'a, ga coto nubu [nu'a ma b'ejña]?"
"r'a ya kjä'i mi b'u̱i ja ra ngumi kja nunu ja ra jnini ri mankjuäntjo pa da tsoni nubu̱ ra amáxac,"	r'a ya kjä'i mi bʉi ja ra ngumi kja nunu ja ra ʒnini ri mankjua̱ntʒo pa da tsono nubʉ ra amáxaʃ
"ra nge'a di o̱t'a nuna noya ra ts'u̱tui ne gatjo to'o da guat'a ja ma jyoje, nu'u̱ to'o da ne, da me̱tsi n'a ra joga m'u̱i ne da m'u̱i mankjuäntjä. ja nubu̱ xa mabu̱ ma noya ge di pe̱tsi ra tsa, dega joga kjä'i ne dega jogat'o̱t'antujni"	"Ra ngë'a di o̱t'a nuna noya ra ts'ü̱tui ne gatyo to'o da guat'a ja ma jyoye, nu'u̱ to'o da ne, da me̱tsi n'a ra joga m'ü̱i ne da m'ü̱i mankjüäntjä. Ja nubü̱ xa mabü̱ ma noya ge di pe̱tsi ra tsa, dega joga kjä'i ne dega jogat'o̱t'antujni"
ra ngejna nuna pa bi ma n'a ra ñ'u mankjuäntjo.	Ra ngejna nuna pa bi ma n'a ra ñ'u maankjuäntjo.
"ra njñu ne ra ngästsi ra b'ist'ofo di juts'iju̱ ja nuna ze̱ki b'ist'ofo, ri ñ'eje ra vii nkjondajmä ra chimalpain,"	"Ra njñu ne ra ngätsi ra b'ist'ofo di juts'iju ja nuna sekhi b'ist'ofo, ri ñ'eje ra vii nkjondajmä ra chimalkpain"
"ra ntjädi ra cuitlahuacatzin bi ena ge ina da o̱t'e nuya bi b'e̱pabi ya nso̱jo̱kjä'i,"	Ra ntjädi ra Cuitlahuacatzin bi ena ge ina da o̱t'e nuya bi b'e̱pabi ya nso̱jo̱kjä'i
"ra nyojo nu'a mi zu ra tepoztlan; ra njñu ra me tizatlan, ra nkjojo mi ñ'eje nuni huehuetlan ne ra nku̱ta mra dänga mictlan."	"Ra ñyojo nu'a mi tsu ra Tepoztlán; ra ñiñu ra me Tizatlán, ra nkjojo mi ñ'ehe nuni Huehuetlán ne ra nkuhta mra däŋga Mictlán."
ri ñ'udi xajño nubia jankja beni ya metlaxcala bi do̱m'i mpaja nuya nso̱jo̱ kjä'i.	ri ñ'uhi xajño nubia jankya beni ya metlaxcala bi do̱mi mpaja nuya nso̱jo̱ kjä'i
"t'ena ge inbi unga mfädi pa gatjo ya kjä'i mi ñ'oui, ge nuna ndada ra marqués da ñ'eje dra jmu ja ma jaije, da ja me̱ti nu'a di pe̱tsije neje dra kjakagije ga mpe̱fije ra jai ge bi umbabi o bi jänbabi ya joga jai ya n'añ'o jnini."	"tʔena ge inbi unga mfädi pa gatxo ya kjäʔi mi ñʔoui, ge nuna ndada ra marqués da ñʔeje dra jmu ja ma jaije, da ja me̱ti nuʔa di pe̱tsije neje dra kjakagije ga mpe̱fije ra jai ge bi umbabi o bi jänbabi ya joga jai ya nʔañʔo jnini."
"xi mi taxki ra ñ'u, imbi tsa da r'anga n'a, jo̱nse̱je̱ mi taxka n'a ja ra bo̱jai. ya y'ofadi mi kju̱t'atjo."	"Xi mi taxki ra ñ'u, imbi tsa da r'anga n'a, jonseje mi taxka n'a ja ra bojai. Ya y'ofadi mi kjut'atjo."
"ya dänga mfu̱nga bo̱kjä bi ntjo, bi kot'i ko ya majkjuai, mi zu̱m'i neje ko ya t'e̱nga ts'u̱t'abo̱kja."	"Ya däŋga mfu̱ŋga bo̱kjä bi ntjo, bi kot'i ko ya majkjuai, mi zum'i neje ko ya t'e̱ŋga ts'u̱t'abo̱kja."
ya r'atsanoya ra sajagún mi mä jankja mi yopa tsini. ya ndeznä bi nkoji inda ñ'udi. mi jatatjo pa bi mu̱di ra ntujni	Ya r'atsanoya ra sahagún mi mä jankja mi yopa tsini. Ya ndeznä bi nkoji inda ñ'udi. Mi jatatyo pa bi mu̱di ra ntuxni
"ya zi b'e̱jña mi ägi ja ya b'a ne ja ya ngo̱de, nuya ñ'o̱jo̱ mbo ja ya ne, ja ya nkjom'ajudi."	"Ya zi be̱jña mi ägi ja ya b'a ne ja ya ngo̱de, nuya ñ'o̱jo̱ mbo ja ya ne, ja ya nkjom'ajudi."
"bi boxro xi 'be̱ts'ina, bido'u̱ ro 'yu̱ni 'na, xi bi bo̱x ro hkjua 'na, bido'u̱ ro ts'ii 'na, xi bo̱xro ts'äre 'na. ge'bu̱ go min pu̱n doja 'na."	"Bi boxro xi bets'ina, bido'u ro yuni na, xi bi box ro hkjua na, bido'u ro ts'ii na, xi boxro ts'are na. Ge'bu go min pun doja na."
bi ma mankjuäntjo jabu̱ mi b'u̱i ra ts'e̱y'e̱jmu bi xipabi;	bi ma mankjuntjo jabu mi b'i ra tse'yemju bi xipabi;
bri kjuajni po nuya dra jmu.	bri kjuajni po nu'ya dra jmu
"di to̱m'ihe ra ñ'etji pa nugagije, n'a ra pa ngu ma n'a ra pa tjogi nekagije di juadije ra nge'a indi tse̱tije nuna b'u̱i t'o̱t'e ko ngekagije man'año ya ntjo, t'e̱nts'igije tji ma jaije ma me̱tije, ju̱kagije ga mpe̱fije nduntji, b'e̱kagije ga jut'ije xduntji ya bokja, n'a ngu n'a ra pa nuna nkjut'i di o̱t'eje man'a te ma tjaije di tuje."	"di tomʔihe ra ñetxi pa nugagije, nʔa ra pa ngu ma nʔa ra pa tʃogi nekagije di juadije ra ngeʔa indi tsetʔije nuna bʔui tʔotʔe ko ngekagije manʔaño ya ntʃo, tʔentʔsigije tʃi ma jaije ma metʔije, jukagije ga mpʔefije nduntʃi, bʔekagije ga jutʔije xduntʃi ya bokʃa, nʔa ngu nʔa ra pa nuna nkʃutʔi di otʔeje manʔa te ma tʃaije di tuje."
gatjo nuna jai ja nuna r'ayo ximjai nkjabu̱ bi tjutuabi nuya nso̱jo̱jä'i inbi tsa bi tjutuabi man'a ra tjuju.	Gatjo nuna jai ja nuna r'ayo ximjai nkjabu̱ bi tjutuabi nuya nso̱jo̱jä'i inbi tsa bi tjutuabi man'a ra tjuju.
"ja mi tso nde, bi mu̱di bi nkja n'a ra jneki ngu nkjagiju̱ dega kjä'i, bi t'ot'e ra b'ai ngu dega kjä'i,"	"Ja mi tso nde, bi mu̱di bi nkya n'a ra jneki ngu nkjagiju̱ dega kya'i, bi t'ot'e ra b'ai ngu dega kya'i,"
"ma bo̱najmu'ije: nuna b'e̱fi ga tsokagije sta kjuatihe gatjo: gi nuti nuua, xa jño bo̱najmu."	"Ma bonaxmu'ije: nuna be̱fi ga cokaxiye sta kyuatije gaxto: gi nuti nu'a, xa jño bonaxmu."
"mi mä dega ts'e̱dira jñä tso̱pu da ts'o̱jo̱bu nuya nzo̱jo̱kjä'i ga jandiju̱ te ma ts'e̱di pe̱tsi, ra nge'a ma akjuä ra quetzalcohuatl b'u̱i nuua ko ngekagiju̱,"	"mi mä dega ts'edirá jñä tsópu da ts'ojóbu nuya nzójkjä'i ga jandíju te ma ts'edi pe̱tsi, ra nge'a ma akjuä ra quetzalcohuatl b'ui nuua ko ngekagíju"
"ne ya nt'u̱i, jankja di tjuts'i ya nt'ofo, nkjap'u̱ neje mä 'ra ya mpeu̱i da fats'i di nt'ot'i ra jñäjñu"	"ne ya ntʉ̱i, jankja di tcuci ya ntʼofo, nkjapʉ̱ neje mä ’ra ya mpe̱ui da fatsʼi di ntʼotʼi ra ñäñu"
"nub'u̱ nu'i ingi kjapi da bo̱nga nu'a ra makja ja nu'a ra jnini, ¿jankja ra yotui, ga tso̱gi nubu̱ ma b'e̱jña? o̱t'a r'ato ya kje̱ya bi mu̱di [ra makja ra bartolomé lópez]"	"Nub'u̱ nu'i ingi kjapi da bo̱nga nu'a ra makja ja nu'a ra jnini, ¿jankja ra yotui, ga tso̱gi nubu̱ ma b'e̱jña? O̱t'a r'ato ya kje̱ya bi mu̱di [ra makja ra Bartolomé López]"
pa ga b'u̱i mpaja ne ga o̱t'e n'a ra nkjondajmä gatjo nu'a ga jandi.	Pa ga bʉi mpaja ne ga oʔte n'a ra nkjondajmä gatjo nu'a ga jandi.
"r'a nuna mi ntjandi ngu nu'a ma tjänkjuaju̱ (ychtlilmatli), xi mra nts'o, mi kuet'e ja ya ngo̱,"	"r'a nuna mi ntjandi ngu nu'a ma tjänkjuaju̱ (ichtlilmatli), xi mra nts'o, mi kuet'e ja ya ngo̱,"
"xa zägi mpaja, nub'u̱ xa nkjabu̱ xa kjapabi ma zu ne inte xa t'o̱tuabi nub'u̱ inda kjapi xa po̱jo̱ bi ya kue̱ ra nge'a ya kjä'i xi mra no̱t'e ne mra jyotekjä'i,"	"Xa zägi mpaja, nub'u xa nkjabu xa kjapabi ma zu ne inte xa t'o tuabi nub'u inda kjapi xa pojo bi ya kue ra nge'a ya kjä'i xi mra no't'e ne mra jyotekjä'i"
"y'o, ri ma ne gi xipabiju̱ ya metlaxcala ge ma r'a ya me̱ti kjä'i ne ri ajuäju̱, ge nu'a ga mä ge xa eje nuua ma jaiju̱, ge di umbabije ma ntjädije."	"yʉ, ri ma ne gi xipabijʉ ya metlaxcala ge ma rʼa ya me̱ti kjäʼi ne ri ajʉäjʉ, ge nuʼa ga mä ge xa eje nuʉa ma jaijʉ, ge di umbabije ma ntjädije."
¿te da o̱t'e ma kjä'iju̱ sta b'e̱diju̱?	¿te da o̱tʔe ma kjäʔiju̱ sta bʔediju̱?
"-da ts'iua:... ri ñ'eje ge'a ma nkjueij'u̱. da o̱t'eje ya ñ'o̱te ko ya je̱m'i, ya ñ'o̱t'eje ko ya ntuts'i. da o̱ts'e̱ ra b'e̱na noya."	"-da ts'iuá... ri ñ'ehe ge'a ma nkjueij'u. da oteje ya ñ'ote ko ya jem'i, ya ñ'oteje ko ya ntuts'i. da ots'e ra b'ena noya."
-dom'i ma akjuäju̱ ge inda yu̱t'a ja ma nguju̱ nuju̱ to'o e̱nts'i pa tji ne da jokuabi ra jonanjyo nub'u̱ sta ne da jyoki ya inda za.	Domi ma akjuaju ge inda yuta ja ma nuguju nuju to'o ents'i pa tji ne da jokabi ra jonanjyo nubu sta ne da jyoki ya inda za.
"-o̱t'a ra mäte gi o̱deju̱, kja gi b'ai nuuaju̱. mont'a ya ngo akjuä; ri kjuat'i ra ngo ga tsunda ma akjuäje."	"-ota ra mate gi odeju, kya gi b'ai nuaju. mont'a ya ngo aküä; ri kyuati ra ngo ga tsunda ma aküäje."
"-xa jño, di b'u̱ije nkjamädije."	"ŋa ǵnɛ, di b'u̱ije ŋkamädiye."
-¿nguande nkjabu̱ ga mäu gra kjuäju̱?	-¿Ngwandé nkjabú ga máu gra kjuájú?
"-ñ'emabagi, ya gabida, ya kjä'iju̱ gi pädi ra ntuni ra mem'onda ba ejeju̱ ga te̱niju̱ma nzu̱teju̱. ko ya mätsa mi te̱je̱, ko ya bu̱'bai ko ngatjo ra ts'e̱di mi te̱je̱ ra ñ'u."	"-ñ'emabagi, ya gabida, ya kjä'iju gi pädi ra ntuni ra mem'onda ba eheju ga teniju̱ma nzu̱teju̱. ko ya mätsa mi te̱je̱, ko ya bu̱'bai ko ngatjo ra tse̱di mi te̱je̱ ra ñ'u."
"bi tse̱ti nuna ngot'i ra m'onda, ngu pede ra dänga b'ede, ya k'oi ne ya nkjändajmä, ngu nu'a ra jmä ra alonso axayaca, gojo n'ate ma pa bi nzo̱t'e nuna pa."	"Bi tsʔéti nuna ngotʔi ra mʔonda, ngu pede ra däŋga bʔéde, ya kʔoi ne ya nkjändäjmä, ngu nuʔa ra jmä ra Alonso Axayaca, gojo nʔate ma pa bi nzō̱tʔe nuna pa."
"into y'o mankjuäntjo, into pa ri nektjo."	"into yʼo maŋkjuaŋtjo, into pa ri nektjo"
"nub'u̱ ndi umbabije ma nkjut'ije xki nzäi ndi da'ije, mi adi n'a tu̱ki neje nub'u̱ ndi unije ya k'astaboja mi jäni made n'a tu̱ki [...]"	"Nub'u̱ ndi umbabíje ma nkjut'íje xki nzäi ndi da'íje, mi adi n'a tu̱ki neje nub'u̱ ndi uníje ya k'astaboja mi jäni made n'a tu̱ki [...]"
"ya miñ'o ko ngejna jmä ri kjojya,"	"ya miŋ'o ko ŋejna hmä ri kjojya,"
bi tso̱jso̱ ra ngo ma akjuäju̱: nubia da fu̱di da guadi ra r'e̱t'a ra pa.	bi tsøjtsö ra ŋo ma akjua̱ju: nubia da fu̱di da guadi ra r'ät'a ra pa