OTS	OTQ
"-pasadores: ""ya nts'äza xi mra nts'u̱t'i mi t'e̱ni ko n'a ra t'e̱nga ts'u̱t'a bo̱kja mi tjutuabi ra ballesta""."	"OTQ: ""ya ntza xa mra ntut'i mi te̱ni ko na ra te̱nga tsut'a bogja mi tjutuabi ra ballesta""."
cantares mexicanos, biblioteca nacional de méxico, ya nt'ofo 1628 bis, folio 16 v.	cantares mexicanos, biblioteca nacional de méxico, ya nd'ofo 1628 bis, folio 16 v.
"ebu̱ bi bo̱ni, bi meui nuni nonohualco, ja ra ngu ra b'ongui jabu̱ ra gabida ne ra malintzin ne ""ra jyadi"" (alvarado) ne ra sandoval."	"OTQ: ebu̱ bi bo̱ni, bi meui nuni nonohualco, ja ra ngu ra b'ongui jabu̱ ra gabida ne ra malintzin ne ""ra dyadi"" (alvarado) ne ra sandoval."
gi jandi ra nt'ofo ra tjuju ra crónicas de la conquista	gi xandi ra nd'ofo ra tyuju ra crónicas de la conquista
guzmán. ja ya je̱m'i b'e̱tsa kje̱ya manteb'u̱ di ge nuua m'onda ne ya jyo, nu'a ra jmä ra 12-conejo (1530) ge xa jmä ge xibú bi yut'i ja ra culhuacan ya ndeznä, nda pablo xochiquetzin, motelchiuhtzin ne ra guzman.	guzmán. ja ya je̱hmi b'ehza kje̱ya manteu̱ di ge nu'a m'onda ne ya jyo, nu'a ra hmä ra 12-conejo (1530) ge xa hmä ge xibu̱ bi yuti ja ra culhuacan ya ndeznä, nda pablo xochiquetzin, motelchiuhtzin ne ra guzman.
ja ga ñ'udiju̱ ra nt'ofo ya ñämfo̱ po ra ntjuts'i ra doctor garibay,	ja ga ñ'ujiu ra nd'ofo ya ñämfo po ra ndjuts'i ra doctor garibay,
ja nu'a jyodi nubia tjutuabi ra san martin.	ja nu'a jyodi nubia tjutuabi ra san martin.
je̱mi unga mfädi ja ra t'u̱ka jnini jabu̱ b'u̱i ya kjä'i teni ra división ra arenas, 27 ra abril ra kje̱ya 1918, ra m'ets'a je̱m'i ra zapata, b'e̱tsi ja ra universidad nacional autónoma de méxico, expediente 29.	jemí unga mfädi ja ra t'uka jnini jabu b'ui ya kjä'i teni ra división ra arenas, 27 ra abril ra kje'ya 1918, ra m'ets'a jem'i ra zapata, b'etsi ja ra universidad nacional autónoma de méxico, expediente 29.
"m'e̱fa ja ra jñuti bri tjätuabi na ra jñe xki tagiri mo̱te, neje bri kjom'a ra xu̱tja ko n'a ra t'axa dutu mra tjujuu ra ""campanillante""."	"m'efa ja ra jñuti bri tjahtuabi na ra jñe xki tagiri mo̱te, neje bri kjoma ra xutja ko n'a ra t'aha dutu mra tjujuu ra ""campanillante""."
ma dada'ije gra ts'u̱tui, di ne gi pädi ge ma me̱t'o instä tjogije nuna tjogi gatjo ya mapa xki r'ani, bi kjuat'i ko ngeke nu̱'u ri b'e̱go, ri me̱fi ya ñämfo̱, ra nge'a makjuäni ra hernando cortés ra ndä gabida,	ma dada'ije gra ts'utui, di ne gi pädi ge ma met'o inste tjogije nuna tjogi gatjo ya mapa xki r'ani, bi kjuat'i ko ngeke nu'u ri b'ego, ri mefi ya ñamfo, ra nge'a makjuani ra hernando cortés ra nda gabida,
mi b'u̱i ya mu̱dimejai mi ñä ra ndeznä ne jabu̱ ra jnini dige'a gatjo ra nxiki m'onda ngu r'a ya yaqui b'u̱i nuni sonora ne ya maya ri ñ'eje nuni yucatán ra nge bi guat'i ja ra tujni bi nkja nuua m'onda fädi ko ra tjuju ra revolución mexicana ya kje̱ya 1910-1919.	mi bʼui ya mudimejai mi ñä ra ndeznä ne jabʼui ra jnini digeʼa gatjo ra nxiki mʼonda ngu rʼa ya yaqui bʼui nuni sonora ne ya maya ri ñʼeje nuni yucatán ra nge bi guatʼi ja ra tujni bi nkja nuua mʼonda fädi ko ra tjuju ra revolución mexicana ya kje̱ya 1910-1919.
mi fo̱tuabi ya ts'u̱tnibo̱kja mi tjutuabi ya jñämfo̱ ra pasadores neje ya bo̱zna ko ya nzafi.	mi fõtuaʼ ya cʼuʼtniʼkja mi cjutuaʼ ya ñä̃mfo ra pasadores nehe ya bozna ko ya nzafi
n'a nt'udi di ge'a nuya ntjoki bri t'o̱t'e ja ya jñä ya ndeznä ra ngätsi ra ntjebe nkje̱ya ra r'e̱t'a ma gu̱to (s. xix), r'a ya jnini ngu ra xicontepec (villa juárez) nuna jyodi koji nuni puebla.	n'a nt'udi di ge'a nuya ntjoki bri t'o̱te ja ya jñä ya ndeznä ra ngätsi ra ntjebe nkje̱ya ra r'e̱ta ma gu̱to (s. xix), r'a ya jnini ngu ra xicontepec (villa juárez) nuna jyodi koji nuni puebla.
"n'a ra t'axa dutu mi pe̱tsi ya k'oi ra ixki, nuna mra tjuju jñämfo̱ ""campaneante resonador""."	"n'a ra t'aha dutu mi pe̱ci ya k'oi ra ixki, nuna mra tcuçu jñämfu ""campaneante resonador""."
ne ri mpe̱fi ja ra dängan gu nt'udi ra tjuju ra facultad de estudios superiores, acatlán, unam,	ne ri mpʼehi ja ra däŋgan gu nt'udi ra tcuçu ra facultad de estudios superiores, acatlán, unam,
ntjandi gatjo nu'a ra munts'i ra tjuju jñämfo̱ ra globalización ge 'a po̱ts'e dega nest'iji, nuna y'o̱te to̱m'i da nkja ra ntjo̱mäte.	ntjandi katjo nu'a ra munt'i ra tjuju ñämfo̱ ra globalización ge 'a po̱t'e dega nest'iji, nuna y'o̱te tom'i da nkia ra ntjomäte.
nu'a ma r'a ya kjä'i mi pädi nuña b'e̱fi bri b'e̱pabi xa jyoki yojo ya mpe̱fi mi fädi ko ra tjuju ra amosqueador ko ya xi ya ts'ints'u̱ xi sta jotjo, gi jutsuabi made dige'a n'a ra zänä dega k'astabokja	nu'a ma r'a ya kjä'i mi pädi nuña b'efi bri b'epabi xa jyoki yojo ya mpëfi mi fädi ko ra tjuju ra amosqueador ko ya xi ya ts'ints'u xi sta jotjo, gi jutsuabi made digë'a n'a ra zänä dega k'astabokja
"nu'a ra munts'a kjä'i bi te̱ni bi zipabi man'a ya b'ede, mi t'ena ge ya kjä'i xki b'u̱i nubu̱ inbi pe̱tsi ra ts'e̱di nu'a mi mä pe m'e̱fa bi kjapi bi nxaxni ya tsu̱tui ne n'a ra diputado mi pe̱tsi ra mfeni xki kot'i mra tjuju ra josé maría lozano, bi y'onga ra jmä pa mar'a ya ñ'oui bi nxanxi: ""ri mo̱te ra tjits'i mi udi ra emiliano zapata, neje bri fädi ngu ra atila nuna bri nkju̱tsi [...] nu'a bi fädi ngu mi je̱gi ya b'e̱go ne'a bi mä da uni da nkja pa gatjo, ingi kjot'i [...]"	"nu'a ra munts'a kjä'i bi te̱ni bi zipabi man'a ya b'ede, mi t'ena ge ya kjä'i xki b'u̱i nubu̱ inbi pe̱tsi ra ts'e̱di nu'a mi mä pe m'e̱fa bi kjapi bi nxaxni ya tsu̱tui ne n'a ra diputado mi pe̱tsi ra mfeni xki kot'i mra tjuju ra josé maría lozano, bi y'onga ra jmä pa mar'a ya ñ'oui bi nxanxi: ""ri mo̱te ra tjits'i mi udi ra emiliano zapata, neje bri fädi ngu ra atila nuna bri nkju̱tsi [...] nu'a bi fädi ngu mi je̱gi ya b'e̱go ne'a bi mä da uni da nkja pa gatjo, ingi kjot'i [...]"
nu'u̱ to'o ñä ra ndenzä ja r'e̱t'a ma r'at'o ya estados.	nu'u to'o ñä ra ndežä ja r'et'a ma r'ato ya estados.
nub'u̱ ri m'e̱jni ne ri b'e̱go ya ñämfo̱ bi kjuat'i ko ngekagije ne bi tso̱jo̱ ra gabida ra tjuju ra hernán cortés, maske indi pädije ge gatjo da za da o̱t'e ne xi ra nzunda maría trinidad,	OTQ: nub'u ri m'ejni ne ri b'ego ya ñamfo bi kjuati ko ngekagije ne bi tsojo ra gabida ra tjuju ra hernán cortés, maske indi padije ge gatjo da za da ote ne xi ra nzunda maría trinidad,
nubia, unga mfädi ja ra ñäjñu kjamädi ra universidad autónoma del estado de hidalgo.	nubia, unga mfädi ja ra ñäjñu kjamädi ra universidad autónoma del estado de hidalgo.
nugi, ra miguel hernández ge di pe̱tsi ma ngu nuni chiyauhtzinco, ko ra t'ek'ei di udi ko nge'i, nuna m'e̱jnant'ofo di joki go tso̱n'i ko nge'i, ma t'ek'ei bo̱najmu'i nda doctor alonso ruiz, ra nk'ojnate ge gi b'ui nuua ja ra jnini ra quamochtitla.	OTQ: nugi, ra miguel hernández ge di pe̱hci ma ngu nuni chiyauhtzinco, ko ra t'ek'ei di udi ko nge'i, nuna m'ejnant'ofo di joki go tso̱n'i ko nge'i, ma t'ek'ei bo̱najmu'i nda doctor alonso ruiz, ra nk'ojnate ge gi b'ui nuua ja ra jnini ra quamochtitla.
nuna je̱m'i bri t'unga mfädi ko ra t'u̱ka ntjint'ant'ofo po ra marcelo díaz salas ne ra luis reyes garcía ja: tialtocan, revista de fuentes para el conocimiento de las culturas indígenas de méxico, vol. vi, 1970, b'ede ra 3, pp. 193-212.	nuna jem'i bri t'unga mfa̱di ko ra t'uka ntshint'ant'ofo po ra marcelo díaz salas ne ra luis reyes garcía ja: tialtocan, revista de fuentes para el conocimiento de las culturas indígenas de méxico, vol. vi, 1970, be̱de ra 3, pp. 193-212.
"nuna jñäpi juts'i ja n'a ra je̱m'i fädi ra derecho canonigo ko ra tjuju jñämfo̱ ngu ra ""solicitación al administrar el sacramento de la confesión""."	"OTQ: nuna hñäpi juts'i ja n'a ra je̱m'i fädi ra derecho canonigo ko ra tjuju hñämfo̱ ngu ra ""solicitación al administrar el sacramento de la confesión""."
nuna m'e̱jna nt'ofo b'e̱tsi ja ra archivo histórico nacional, madrid, documento 165. bi unga mfädi ja ra nt'ofo ya zubi po ra y'ofo ra tjuju ra arthur j. o. anderson et al.: byond the codices: the nahua view of colonial mexico, berkeley, university of california press, 1976, pp. 181-187.	nuna m'ejna nt'ofu b'etsi xa ra archivo histórico nacional, madrid, documento 165. bi unga mfa'di xa ra nt'ofu ya zubi po ra y'ofu ra tjuju ra arthur j. o. anderson et al.: byond the codices: the nahua view of colonial mexico, berkeley, university of california press, 1976, pp. 181-187.
nuna nt'ofo b'e̱tsi ja ra archivo general de indias, sevilla, audiencia de méxico 168, bi unga dra fädi po ra miguel león-portilla ja cultura en peligro, méxico, alianza editorial mexicana, 1976, pp. 102-103.	nuna nt'ofi b'etsi ja ra archivo general de indias, sevilla, audiencia de méxico 168, bi unga dra fadi po ra miguel león-portilla ja cultura en peligro, méxico, alianza editorial mexicana, 1976, pp. 102-103.
nuna pika je̱m'i kja te mä b'e̱tsi ja ra archivo general de la nación, nuua m'onda ne kja ja ra nduntji ya jnini, njabu̱ ngu ya nzaya nuni manjyati ne mar'a ya jnini, o̱t'e gi o̱de ra jñä ra mu̱dimejai.	nuna pika jem'i kja te mä b'etsi ja ra archivo general de la nación, nuua m'onda ne kja ja ra ndutji ya jnini, njabu ngu ya nzaja nuni manjyati ne mar'a ya jnini, ote gi ode ra jña ra mudimejai.
nuua t'unga yojo ya jmä, kuän'ajmä ya ndeznä ne tjuts'i ja n'a ra k'oi mä mäkjuäni ri ntje̱ui n'a ya dänga ra tju̱ajmä manteb'u̱, nuua pede nu'a gatjo ya ts'otjogi bi y'o̱t'a dega fete ra alvarado.	nuua t'unga yojo ya hmä, kwän'ajmä ya ndeznä ne tjuts'i ja n'a ra k'oi mä mäkjuni ri ntje̱ui n'a ya dänga ra tju̱ajmä manteb'u̱, nuua pede nu'a gatjo ya ts'otjogi bi y'o̱t'a dega fete ra alvarado.
nuua ya mu̱di noya ra motolinia, ja ra mu̱di nkoji bi t'o̱t'e ko ra tjuju ra tratado tercero ra dänga b´ede ya mu̱dimejai nuua r´ayo manjyati:	nuha ya mudi noya ra motolinia, ja ra mudi nkoji bi t'ote ko ra tjiju ra tratado tercero ra danga behe ya mudimejai nuha r'ayo manjyati
"pa da t'unga mfädi gatjo nu'u̱ bi nkja, n'a di ge'u̱ ko ngu fe̱ti nu'a makjuäni mi joki mi tjutsuabi ya jnei ne ya b'ida. b'u̱i man'a ra mfädi da t'o̱t'a ra nt'udi, nu'a ra tjuju ""fe̱ta nu'a makjuäni bi nja nub'u̱ ra tsokat'o̱tamfeni (teatro de la conquista)""."	"pa da t'unga mfädi gatyo nu'u bi nkya, n'a di ge'u ko ngu feti nu'a makyuäni mi yoki mi tyutsyabi ya ynei ne ya b'ida. b'u'i mana ra mfädi da t'o't'a ra nt'udi, nu'a ra tyuyu ""feta nu'a makyuäni bi nya nub'u ra tsykatty'o'tamfeni (teatro de la conquista)""."
ra europa -mra nxika jai manteb'u̱, mi pe̱tsa n'a ra nxika b'ede-	ra europa -mra nxika jai mante̱b'u, mi pe̱tsa n'a ra nxika b'e̱de-
ra fernando ramírez mä ge nuna jyodi ri nge̱pu̱ jabu̱ kja n'a ra nikja ra san fernando ne ra ermita dige'a ya mártires dige'a san hipólito,	ra fernando ramírez mä ge nuna jyodi ri ngëpu jabu kja n'a ra nikya ra san fernando ne ra ermita dige'a ya mártires dige'a san hipólito,
"ra fernando de alva ixtlilxóchitl, fernando de, xiii relación: ""ra ñ'eje ya ñämfo̱ ne ra fu̱di ra nkanfri ra evangelio""."	"ra fernando de alva ixtlilxóchitl, fernando de, xiii relación: ""ra ñ'ehe ya ñämpho ne ra hudi ra nkaphri ra evangelio"""
ra kuän'ajma ra n luz jiménez bi juts'i ra fernando horkasitas bi unga mfädi ne bi r'atsi nuña jmä), de porfirio díaz zapata, memoria nábuatl de milpa alta, méxico, unam,, instituto de investigaciones históricas, 1974, p. 105	ra kuän'ajma ra n luz jiménez bi juts'i ra fernando horkasitas bi uŋga mfädi ne bi r'atsi nuña jmä, de porfirio díaz zapata, memoria náhuatl de milpa alta, méxico, unam, instituto de investigaciones históricas, 1974, p. 105
ra raymundo isidro alavez, bi b'u̱i'i nuni ra boxtha chico, san salvador, estado de hidalgo	ra raymundo isidro alavez, bi b'ï'i nuni ra boxt'a chico, san salvador, estado de hidalgo
ra jmä ra fundación de santo tomás ajusco, archivo general de la nación, méxico, ramo de tierras vol. 2676, expediente. 4, archivo histórico de la biblioteca nacional de antropología, colección antigua, vol. 254, fojas 259 r.- 260 v.	ra hmä ra fundación de santo tomás ajusco, archivo general de la nación, méxico, ramo de tierras vol. 2676, expediente 4, archivo histórico de la biblioteca nacional de antropología, colección antigua, vol. 254, fojas 259 r.- 260 v.
ra makja mra tjuju ra toribio benavente, motolinia,	ra maxka mra txuxu ra toribio benavente, motolinia,
tlauhquechol: ra ts'ints'u̱ xa ntjeni pode ge'a ra flamenco o ra guacamaya, pode ge gatjo ra tje̱nga ts'ints'u̱ ne dänga.	OTQ: tlahkecho:l ra ts'ints'u xa ntjeni pode he'a ra flamenco o ra guacamaya, pode he gatyo ra che:nga ts'ints'u ne dangwa.
xkri tso̱ngä ngostji, kja jejni ya 'ñu; nä'ä rí ma nxamädo, ja nä'ä rí ma mäbo̱za. antes de	xkri tso̱ngä ngotsi, kya heyni ya 'nu; na'a ri ma nxamadu, ya na'a ri ma mabuza.
ya b'e̱go ne ya b'e̱tri di ge'a nu'a ra dänga ndä ra ndada ra tjuju ra esteban de guzmán ra nzaya di gekua m'onda, ra ndada ra hernando pimentel, ra ndada ra antonio cortés, ra ndada xuua (juan) nuna ra mecoyoacan, ra ndada pedro motecuhzoma, me ma r'a ya kuänmi (firmas).	ya be̱go ne ya be̱tri di ge'a nu'a ra dangwa nda ra ndaha ra tjiju ra esteban de guzmán ra nzaja di gekua m'onda, ra ndaha ra hernando pimentel, ra ndaha ra antonio cortés, ra ndaha xuua (juan) nuna ra mecoyoacan, ra ndaha pedro motecuhzoma, me ma r'a ya kwa̱nmi (firmas).
ya kuän' ajmä xa tjogi manteb'u̱e ge xa tjäst'i nu'a gatjo ra ntjandi to'o bi b'e̱di ge xa pu̱ngajñä nuna jmä getbu̱ n'ate ya jñäki ge ñä ya nso̱jo̱ jñäki ne xa y'oni nuna nt'ofo neje ja ra jñäki yazi xada kjä'i , ge'a nuna jñäki fadi ja ra jñämfo ko ra tjuju ra sistema braile.	ya kuän' ajmä xa tjogi manteb'u̱e ge xa tjäst'i nu'a gatjo ra ntjandi to'o bi b'e̱di ge xa pungajñä nuna jmä getbu̱ n'ate ya jñäki ge ñä ya nso̱jo̱ jñäki ne xa y'oni nuna nt'ofo neje ja ra jñäki yazi xada kjä'i, ge'a nuna jñäki fadi ja ra jñämfo ko ra tjuju ra sistema braille.
ya r'atsanoya ra sahagán, ndoxkjua k'oi florentino, lib. xii, caps. xxix-xli (versión de ángel ma. garibay k.).	ya r'atsanuya ra sahagán, ndojkjua k'oi florentino, lib. xii, caps. xxix-xli (versión de ángel ma. garibay k.).
despwés ya desde k'a ra momento ya k'a ya jíngi bénya'wi já té bimáju̱ k'a ra charroya'wi	despwés ya desde k'a ra momento ya k'a ya xíngi bénya'wi xá té bimáju̱ k'a ra charroya'wi
despwés ya xo bimu̱fí pe xo diario diario bu̱ nchúi mitsu̱ k'a ra charro mi'óbí k'a ra mikwála	despwés ya xo bimfi pe xo diario diario bu nchui mitsu k'a ra charro miobi k'a ra mikwala
goparejájé primero 'á k'a ra parte ánk'ú dínant'í	OTQ: goparehájé primero 'a k'a ra parte ánk'ú dinánt'i
i asta fecha pues ignoro mucho pero másk'ŭ mäkjámá más ndímáignorajéwi	i asta fecha pues ignoro mucho pero másk'ŭ mäkjámá más ndímáignorajéwi
indu̱odiagí bastante	indu̱odiagí baste
inga se̱je̱ ra nntjandi ra manjyati ne ra portuguesa neje ra francesa, inglesa, alemana e italiana,	inga se̱je̱ ra ntjandi ra manjyati ne ra portuguesa neje ra francesa, inglesa, alemana e italiana,
k'a mädämé para ke mantenigíjé dígotjó mäbäjtsí pues ni modo dísufréjé	k'a mädamé para ke mantenijé digotjó mäbajtsí pues ni modo disujréjé
kómá'u̱té ya fuente níjí	kómá'u̱té ya fuente níhi
ne bi unbabi nduntji ya baba, bi enbabi ge mi ne da ñäui ra ndä (emperador) mi b'u̱i nuni manjyati, ne da jäni ra dänga ts'ofo ra evangelio,	ne bi umbabi nduntji ya baba, bi enbabi ge mi ne da ñäui ra ndä (emperador) mi b'ui nuni manjyati, ne da jäni ra dänga ts'ofi ra evangelio,
normalmente gójo	OTQ: normalmente gójo
panteón ga dó	pantéon ga dó
pero de sesenta pantsítjá pa gotjók'ŭ kompletamente xatjó ndímáfădijé	pero de sesenta pantsítjá pa gotjók'ŭ kompletamente xatjó ndímáfadijé
pero eso sí binújgí mängŭjé kada ná	pero eso sí binuxí mäŋuxé kada ná
"po nuya kja'i to'o mi pede ge fädi ko ra tjuju ya ""cronistas de las indias”"	"po nuya kja'i to'o mi pede ge fädi ko ra tcuçu ya ""cronistas de las indias”"
pues este kábádá balewa este mínimo siento sinkwenta	pues este kabáda balewa este míno siento sinkuenta
pues nimodo bisufré k'a más ante mäabwelitajé komo mbu̱i enkajoso ra ntsoya	pues nimodo bisufré k'a más ante mäbwelitajé komo mbu̱i enkajoso ra ntsoya
ra nku̱t'i ra juajni ne ya ñ'udi ntjutsi ra agustin yáñez 2da. edición. biblioteca del estudiante universitario, unam, 1950.	ra nkut'i ra huaxni ne ya ñ'uhi ntjutse ra agustin yáñez 2da. edición. biblioteca del estudiante universitario, unam, 1950.
solamente ya riko alkansabi	OTQ: solamente ya riko alkasabi
xi ra tí na ta komedór 'á itsí na ta alimento k'a ra ndăni	xi ra tí na ta komedor 'á itsí na ta alimento k'a ra ndani
xo mitajá ra ntsoya mitá sínko pesos ra béjña dos sinkwenta	xõ mitajá ra ntsoya mitá síngko pesõs ra béjña dos sinkwenta
xo takja mä sesenta wik'a takja mä sesenta bitajkíjéya'wik'a	xö takya mä sesenta 'wik'a takya mä sesenta bitaxkíjeya'wik'a
á panteón ga dó níjí	á pantéon ga dó níjí
ñúdigejña dabadijíya' razo''ya' mientra más dandu̱jté	ñudigejña dabadjíya' razó'ya' mientra máj danduhté
-nu'u̱ dige'u̱ b'u̱i nuni maxey (tolimán ne amealco), dige'u̱ temoaya nuni ra ra jyodi estado de méxico ne mar'a ya jyodi nuni puebla ne veracruz	-nu'u̱ dige'u̱ b'i nuni maxey (tolimán ne amealco), dige'u̱ temoaya nuni ra ra jyodi estado de méxico ne mar'a ya jyodi nuni puebla ne veracruz
ne mätajekitjo di kja getbu̱, ra jñäpi ra joel martinez hernández ne ra jotjo tjuajmä ra natalio hernández xocoyotzin, nuya yojo ya xajnate ri ñ'eje ya y'u̱ dige'u̱ ya ndeznä.	ne majekitjo di kja getbu, ra jñäpi ra joel martinez hernández ne ra jotjo tjuajmä ra natalio hernández xocoyotzin, nuya yojo ya xajnate ri ñ'eje ya y'u dige'u ya ndeznä.
"-n'ate pa n'a ra zänä de ra r'e̱t'a ma jñäto ""zänä"" mi zo̱ta ya munts'i ya n'ate ya pa ge mi joki ra xihuitl o ""ra m'ede ra kje̱ya"""	"OTQ: -n'date pa n'a ra tsänä de ra r'et'a ma ñäto ""tsänä"" mi tsota ya munts'i ya n'date ya pa ge mi joki ra shiuitl o ""ra m'ede ra këya"""
bi ma di gepu̱ jam''u̱ ra ngo pa da ts'itje ya it'adeje (Tlahuano) ba po̱ni nubu̱ tlapechhuan. mra ngo ra izcalli.	bi ma di gepʉ jamʉ ra ŋo pa da ts'itxe ya it'adeje (Tlahuano) ba pʉni nʉbʉ tlapečuan. mra ŋo ra izkali.
bi mu̱di da jyoka ya t'u̱kats'u̱fabo̱kja. ge'a ra ntujni bi nkja nuni Coyohuehuetzin ne ma gojo ba nkja.	bi mu̱di da dyoka ya t'ukats'ufabo̱kja. ge'a ra ntuxni bi nkya nuni Coyohuehuetzin ne ma gojo ba nkya.
bri tjo ra cuauhnochtli, ra gabida tlacatecco, ra cuapan, ra gabida huitznáhuac, ra makja Amantlan, ne ra makja tlacopan.	OTQ: bri txo ra kwawnochtli, ra gabida tlakateko, ra kwapan, ra gabida witznawak, ra makya Amantlan, ne ra makya tlakopan.
bri ts'u̱tuabi ja ra y'u̱ga n'a ra nto̱de dega t'u̱ka joga do dega chalchihuite: made mi juts'i n'a ra tsant'i dega k'astabokja.	OTQ: bri ts'utuabi ja ra y'uga n'a ra ntode dega t'uka joga do dega chalchihuite: made mi juts'i n'a ra tsanti dega k'astabokja
Castañeda, ra t'u ra Aquiyahualcatecuhtli, m ra ndä nuni tlaxcala.	Castañeda, ra t'u ra Aquiyahualcatecuhtli, m ra ndo nuni tlaxcala.
Coaíhuitl mra gabida ndeznä nuya mapa digeá ra t'o̱t'ats' okamfeni.	Coaíhuitl mra gabida ndežnä nuya mapa digeá ra t'o̱t'ats' okamfeni.
di gepu̱ ba koi pa nuni ra Xochimilco. nubu̱ ba tu ya kjä'i ya metlatelolco	di ɣepu ba koi pa nuni ra Xochimilco. nubu ba tu ya kjä'i ya metlatelolco
ebu̱ ba eje man'aki ba te̱nga ra t'o̱jo̱ ra tjuju ra Citlaltépec. Tlacopan, nubia ba o̱t'ra b'u̱i ja ra ndo̱m'ijmu.	OTQ: ebu ba ehe man'aki ba te̱nga ra t'o̱jo̱ ra tcuçu ra Citlaltépec. Tlacopan, nubia ba o̱t'ra b'u̱i xa ra ndo̱m'ijmu.
ebu̱ bi dädi ra Cihuacóatl:	ebu̱ bi dädi ra Cihuacóatl
ebu̱ bi ñä ra Cuauhtémoc bi xipabi ra Cihuacóatl:	ebu̱ bi ñä ra Cuauhtémoc bi xipabi ra Cihuacóatl
gojo n'ate ya pa ne ebu̱ bi yopa bo̱ni pa di mani ra Huaxtepec, ra Cuauhnahuac (Cuernavaca).	gojo n'ate ya pa ne ebu̱ bi yopa bo̱ni pa di mani ra Wahtepek, ra Kwarnawak (Cuernavaca).
gue dá nhuat'i mbo kja ra ximjai,	OTQ: gwe dá ñuat'i mbo kya ra shimjai,
i nte ra nge'a, ya jmä juts'i ja ra ndäxkjua k'oi ra códice ra ramírez uni nuna b'e̱de mä makjuäni ngu mä ra ntje̱ka b'ede ne ra ndädi nu'a ra nänä mra tjuju ra yacotzin, ra nänä ra ixtlilxóchitl,	i nte ra ngä'a, ya hmä juts'i ja ra ndäxkjua k'oi ra códice ra ramírez uni nuna b'ëde mä makjuäni ngu mä ra ntjëka b'ede ne ra ndädi nu'a ra nänä mra tjiju ra yacotzin, ra nänä ra ixtlilxóchitl,
inda jyo ko ra ndäxjua ixtlilxóchtil, ra dada ra Nezahualcóyotl ni ko ra fernando de alva ixtlilxóchitl.	inda dyo ko ra ndäxwa ixtlilxóchtil, ra dada ra Nezahualcóyotl ni ko ra fernando de alva ixtlilxóchitl.
k o ya bu̱' bai, ko ya makahuai,	kʌ ɲa bu̱' bai, kʌ ɲa makahuai,
mi fudi da t'axka ra xudi ba ts'i, bri tját'a ja n'a ra za mi b'ai ja ra ngu ra Ahuizotzin nuni ra Acatliyacapan.	mi xudi da t'axka ra xudi ba ts'i, bri tját'a ja n'a ra za mi b'ai ja ra ngu ra Ahuizotzin nuni ra Acatliyacapan.
mi gu̱t'a ra ñ'u̱ n'a ra makja ge'a mra b'e̱fi mi zu nu'a ra mäka jai mra tjuju ra Yohualichan.	mi gu̱t'a ra ñ'u̱ n'a ra makya ge'a mra b'e̱fi mi zu nu'a ra mäka jai mra tjuju ra Yohualichan.
mi y'o y'oua, mi tuts'i ya bu̱'bai dega za, ne r'a mi jä dega bo̱ja ne ya mahuai.	mi y'ö y'ua, mi tuts'i ya bu̱'bäi dega za, ne r'ä mi jä dega bo̱ja ne ya mahuai.
mra ngu ra Aztautzin ge'a mi kja getbu̱ nuni ra Amáxac.	mra ngu ra Aztautzin ge'a mi kja getbu̱ nuni ra Amáxac → mra ngu ra Aztautzin ge'a mi kja getbũ nuni ra Amáxac
n'a ra jyo ne man'a bi xokuabi ra debi. ra Cuauhtemoctzin bri xokuabi ra debi ge'a se̱je̱.	OTQ: n'a ra ʒyo ne mana bi xokabi ra devi. ra Cuauhtemoctzin bri xokabi ra devi ge'a sehe.
ne m'e̱fa bi ma xki jäki ya je dega magabi, ñätsi bi ntsaya ra mahuai ne ra bu̱'bai, bri nkjonda ya bo̱najmu nuni Acachinanco.	ne m'efa bi ma xki jäki ya je dega magabi, ñätsi bi ntsaya ra mahuai ne ra bu'bai, bri nkjonda ya bonajmu nuni Acachinanco.
ne nkjabu̱ bri t'ot'e neje ko mar'a ya bo̱najmu mi pe̱tsi ra t'u̱ka tsu̱tui ja ya t'u̱ka jnini, nuyu̱ to'o mi b'e̱pi da t'o̱t'e ngu nuni Xalapan, Tlaxcalan, Tehuantepec, Oaxaca neje mar'a ya bo̱najmu mar'a ya t'u̱ka jnini jabu̱ bi guat'i ya nduste, ya dumantjuju dega k'astaboja, ge ya tjuju ya kristiano [...]	ne nkjabu̱ bri t'ote neje ko mar'a ya bonajmu mi petsi ra t'uka tsutui ja ya t'uka jnini, nuyu̱ to'o mi bepi da t'ote ngu nuni Xalapan, Tlaxcalan, Tehuantepec, Oaxaca neje mar'a ya bonajmu mar'a ya t'uka jnini jabu bi gwati ya nduste, ya dumantyuju dega k'astaboja, ge ya tyu tyu ya kristiano
ne nu'a ri däme, pu̱ ñ'a'i, nugi ga ma ga tsogi'i nuni Cuetlachcoapan [n'a ra jnini nuni puebla],	ne nua ri däme, pu ñai, nugi ga ma ga tsogi'i nuni Cuetlachcoapan [ña ra jnini nuni puebla],
ne nu'u̱ bi mani dra ts'okat'o̱t'amfeni nuni Michoacán, Xalisco, Culhuacan ne nuni neje Pánuco, ne nuni Oaxaca, Tehuantepec ne Guatemala, ne nuua ra r'ayo majyati, nub'u̱ bri t'o̱t'a ra mabagi pa dra uadi dra t'o̱t'a nu'a ra ts'okat'o̱t'amfeni inda tsogije se̱je̱.	ne nu'u̱ bi mani dra ts'okato̱t'amfeni nuni Michoacán, Xalisco, Culhuacan ne nuni neje Pánuco, ne nuni Oaxaca, Tehuantepec ne Guatemala, ne nuua ra r'ayo majyati, nub'u̱ bri t'o̱ta ra mabagi pa dra uadi dra t'o̱ta nu'a ra ts'okato̱t'amfeni inda tsogiye se̱ye̱.
nejege'a ra ngätsi. mi jä ya mpe̱fi dega mabagi,ya nkjom'a te ne ya fu̱nbo̱kja, inte ma mahuai mi jä ni ge'a ya bu'bai.	nehege'a ra ngätsi. mi jä ya mpe̱fi dega mabagi,ya nkjom'a te ne ya fu̱nbo̱kja, inte ma mahuai mi jä ni ge'a ya bu'bai.
njabu̱ bi bo̱nga dega xui. mra ngo nub'u̱ ra Tecuílhuitl bi bo̱nga: nub'u̱ bi kja ya du ja ra r'ani ra deje ya u̱erna.	OTQ: ñabũ bi bõnga dega xui. mra ngo nub'ũ ra Tecuílhuitl bi bõnga: nub'ũ bi kya ya du ja ra r'ani ra deye ya u̱erna.
nub'u̱ bi tjandi ra Tzihuacpopoca, bi t'ena:	OTQ: nub'u̱ bi txandi ra Tzihuacpopoca, bi t'ena:
nub'u̱ ya ñämfo̱ bi jandi ge xa ñ'eje nubu̱ da tsu̱di, ge mi tekuabi ra nest'iji, m'estjo bi munts'i bi miji ya mahuai.	nub'u̱ ya ñämpho̱ bi jandi ge xa ñ'eeje nubu̱ da tsu̱di, ge mi tekua̱bi ra nest'iji, m'esto̱ bi munts'i bi miji ya mahuai.
nuna kjä'i inbi tsa bi tjädi makjuäni nu'a ra nt'ani. ingra nge'a nuya pa bi jneki n'a ra jyoya jä'i ra macehual (hombre de pueblo),	OTQ: nuna kjä'i inbi tsa bi txädi makjuäni nu'a ra nt'ani. ingra nge'a nuya pa bi jneki n'a ra jyoya jä'i ra macehual (hombre de pueblo)
nuna nte̱nga b'ede ja bri jat'i ra Tzihuacpopocatzin, bi o̱t'e da tjogi ge'a ra ts'e̱y'e̱jmu. inbi bo̱nga nuna nt'o̱t'e bi tsu̱diju̱ ko ma r'a ya b'e̱jni. ma ra ya ñ'ete inbi jopi da kju̱ man'aki ra ñ'u nuya ts'okate. pe nuya inbi joki ra b'ai.	OTQ: nuna ntenga b'ede ja bri jat'i ra Tzihuacpopocatzin, bi ote da tjogi ge'a ra tsejmuj. inbi bonga nuna nto'e bi tsudiju ko ma r'a ya bejni. ma ra ya ñete inbi jopi da kju man'aki ra ñu nuya ts'okate. pe nuya inbi joki ra b'ai.
nuua di udije ra jñäpi bi nto̱t'e bi nkja ra agosto ra kje̱ya 1595, n'a ra kjä'i mra tjuju ra miguel Hernández, ra me Chiyauhtzinco,	nuua di udie ra jñäpi bi nto̱t'e bi nkia ra agosto ra kje̱ya 1595, n'a ra kjä'i mra tjuju ra miguel Hernández, ra me Chiyauhtzinco,
nuya bo̱najmu ya mem'onda ñätsi bi ñäui ra Cihuacóatl Tlacotzin m'estjo bi tjädi:	nuya bonhamu ya mem'onda ñätsi bi ñäui ra Cihuacóatl Tlacotzin m'estjo bi tjädi
ra Tlacatécatl mra me Cuauhtitlan ne ra bktri ra mbot'a ngu bri kjapi ya tsat'yo bi zi.	ra Tlacatécatl mra me Cuauhtitlan ne ra paktri ra mboka'a ngu bri kjapi ya tsat'yo bi zi.
ra doy'e̱ pajni xki njom'i ko ya chalchihuite.	ra doy'e̱ pajni xki njom'i ko ya chalchihuite.
ra mu̱di ra Cuauhtémoc, ra jmu ra bondo, ra nyojo ra tlatsotzin, ra Cihuacóatl ra njñu ra oquiztzin, ra bo̱najmu ja ra nini ra aztsapotzaltso Mexicapan, ra ngojo ra panitzin, ra bo̱najmu nuni ra Ecatepec,	ra mudi ra Cuauhtémoc, ra jmu ra bondo, ra ñojo ra tlatsotzin, ra Cihuacóatl ra ñu ra oquiztzin, ra bonajmu ja ra nini ra aztsapotzaltso Mexicapan, ra ngojo ra panitzin, ra bonajmu nuni ra Ecatepec
ra mu̱di ra pa mi o̱t'e ra ngo ra mäkime ra u, ra tjuju ra Huixtocihuatl	ra mu̱di ra pa mi o̱t'e ra ŋo ra mäkime ra u, ra txuxu ra Huixtocihuatl
ra nge'a bi mu̱ni ko ra mahuai ja ra xu̱tja nu'a to'o bi umbabi ra kji.	ra ngia bi muni ko ra mahui ja ra xutja nu'a to'o bi umbabi ra kji
ra nyojo, bi tjo ra ndä ra Nauhtla, mra tjuju ra Cohualpopocatzin.	ra ñojo, bi tjo ra ndä ra Nauhtla, mra tjuju ra Cohualpopocatzin.
unga ya ngue̱nda te ra ts'omu̱i mi bu̱'i ne mi kjapi da ntso̱m'i nuya macehualtin, nkjabu̱ mi tjutuabi ya kjä'i mi b'u̱i te ma za	unga ya ngenda te ra ts'omui mi bu'i ne mi kjapi da ntso'mi nuya macehualtin, nkjabu mi tjutuabi ya kjä'i mi b'u'i te ma za
xib'u̱ bri fádi ge nuya je mi kja nuni ra Cuauhchichilco, ja Xaltocan; ge mi pttsi ya ndá.	xib'u bri fadi ge nuya je mi kya nuni ra Cuauhchichilco, ja Xaltocan; ge mi ptsi ya nda.
xki mbo̱ni nubu̱ ra jyodi ra Cuehuecatitlan,	xki mbøni nubøni ra dyodi ra Cuehuecatitlan,
xki tjete ra ixtlilxóchitl ne ra ku ra Cohuanacotzin ko ya je dega dänga ndä bi mu̱di da jäni ra joga ts'ofo ya evangelio,	xki tjete ra istlilxóchitl ne ra ku ra Cohuanacotzin ko ya je dega dänga ndä bi mu̱di da jäni ra joga ts'ofi ya evangelio,
ya dänga ñu̱ni nsafi, ya nsafi, ya mahuai, jangu nu'u̱ gatjo xki tagi mbo ja ra jñe.	ya däŋga ñuni nsahi, ya nsahi, ya mahwai, jangu nu'u gatyo xki tagi mbo ja ra jñe.
bi o̱tuabi nu'a ra makja xki nk'ojni mra tjuju ra alonso ruiz, ge mi y'o nuni juamuxtitan (Huamuxtitlan) nuni ra jyodi guerrero.	bi o̱tuabi nu'a ra makya xki nk'ojni mra tjuju ra alonso ruiz, ge mi y'o nuni juamuxtitan (Huamuxtitlan) nuni ra jyodi guerrero.
di pädi xajño nuna b'e̱fi neje yojo to'o di pädi da mpe̱fi da y'este nuya joga do majye̱gi ya xito, mra tjuju ra ambetz'ihuay.	di pädi xajño nuna b'efi neje yojo to'o di pädi da mpefi da y'este nuya joga do majyegi ya xito, mra tjuyu ra ambec'ihuay.
dra tjoki ra nto̱de, ra ketzal dra b'e̱ nuni Coyohuacan.	dra tjoki ra ndoe, ra ketsal dra b'e nuni Coyohuacan.
e mi r'ani dega xui ra Cihuacóatl g'ea mi zoni ne mı mafi.	e mi r'ani dega xui ra Cihuacóatl g'ea mi zoni ne mı mafi
ebu̱ bi gäi jabu̱ mi to̱ge ebu̱ bi yopa ma ja ra jnini ra Cuetaxtlan,	ebu̱ bi gäi jabu̱ mi to̱xe ebu̱ bi yopa ma ja ra jnini ra Cuetaxtlan,
ge'a ra mu̱di ra tjuju ra Hernando, ra nge'a nkjabu̱ mra tjuju ra takjä ra Cortés neje nkjabu̱ mra tjuju ra ndä Católico ne ra ku ra Cohuanacotzin bi tjutuabi ra Pedro po ra Pedro Alvarado ra nge'a ra takjä,	ge'e ra mu̱di ra txuxu ra Hernando, ra nge'e nkjabu̱ mra txuxu ra takjä ra Cortés neje nkjabu̱ mra txuxu ra ndä Católico ne ra ku ra Cohuanacotzin bi txutuabi ra Pedro po ra Pedro Alvarado ra nge'e ra takjä,
ma n'a mi b'ai nuni teotletso, jabu̱ ra ñ'u̱ pa manjuäntjo pa da zo̱ni nuni ra peñón (Tepetzinco).	ma n'a mi b'ai nuni teotlétso, jabu̱ ra ñ'u̱ pa manjuänto pa da zoni nuni ra peñón
"mi tso̱jo̱ getbu̱ ra fu̱nga t'o̱jo̱, jabu̱ mi tjutuabi ""takjón ra nxu̱ni, nkjabu̱ bi jutuabi ya ndeznä ya b'e̱jnanoya bi pe̱jni ra ts'e̱y'e̱jmu, mi gu̱t'a ra ñ'u ra Tzihuacpopocatzin, bi bo̱nga ja ra ñ'u."	"mi cöjo getbu ra funga t'ojo, jabu mi tcutuabi ""takjón ra nxuni, nkjabu bi jutuabi ya ndeznä ya bejnanoya bi pejni ra tceyemju, mi gut'a ra ñu ra Tzihuacpopocatzin, bi bonga ja ra ñu."
mra ku ra Cacamatzin mra bo̱najmu nuni Tetzcoco mri ñ'oui va kjä'i mi y'o mpaja.	mra ku ra Cacamatzin mra bo̱najmu nuni Tetzcoco mri ñ'ui va kjä'i mi y'o mpaja
n'a ra nto̱de dega chalchihuite, xi m'et'e dega ze̱ka do, neje mi pe̱tsi n'a ra tsant'i de ga k'astabokja.	n'a ra ndoe dega calciuite, xi m'ete dega zeka do, neje mi petsi n'a ra tsanti de ga k'astabokya.
ne nduntji ya ambetz'ihuay ne mar'a joga do mi pe̱tsi ra mu'ui:	ne nduntji ya ambec'ihuai ne mar'a jogi do mi pe̱ci ra mu'ui:
neje n'a ya tje̱stji dega mboťahuaido.	nehe n'a ya tyestxi dega mbotahwaido.
nuna bi o̱t'a ra ntso̱m'i ra nge'a neje nuya ya b'e̱datsi bi tsini ko ra Cortés ne ra Cohuanacotzin ne ra ixtlilxóchitl xki nsofo pa ra ixtlilxóchitl da gu̱ka ya kjä'i ge mi zu ya jyodi, nkjabu̱ mi pe̱jna akjuä da t'o̱t'e.	nuna bi o̱t'a ra ntso̱m'i ra nge'a neje nuya ya b'e̱datsi bi tsini ko ra Cortés ne ra Cohuanacotzin ne ra ixtlilxóchitl xki nsofo pa ra ixtlilxóchitl da gu̱ka ya kjä'i ge mi zu ya jyodi, nkjabu̱ mi pe̱jna akjuä da t'o̱t'e
nuna nt'o̱t'e bi ntjandi xa nts'ogi njabu̱ bri tjutuabi, bi ena ge mra nzu̱te ko ma m'u̱jai ra nzu̱te ne mi tjutsuabi ko ya mpe̱bi dega mabagì, jabu̱ jmä ge n'a di ge'u̱ bi y'e̱nga n'a ra do, ko nge'a bi jyo, nu'u̱ mar'a ya b'e̱go ge mä ge nu'u̱ se̱je̱ ya ñämfo̱ bi jyo bi mu̱tu'a n'a ra mahuai ja ri ngati bi mu̱tuabi n'a ra nzu̱ni.	nuna nt'o̱te bi ntjandi xa nts'ogi njabu̱ bri tjutuabi, bi ena ge mra nzu̱te ko ma m'u̱jai ra nzu̱te ne mi tjutsuabi ko ya mpe̱bi dega mabagi, jabu̱ jma ge n'a di ge'u̱ bi y'enga n'a ra do, ko nge'a bi jyo, nu'u̱ mar'a ya b'ego ge ma ge nu'u̱ seje̱ ya ñamfo̱ bi jyo bi mutu'a n'a ra mahuai ja ri ngati bi mutuabi n'a ra nzu̱ni.
ra Cuauhtémoc, Tlacotzin, ra Cihuacóatl, Oquiztzin, Panitzin, Motelhuihtzin; nuna bi sofo ra tsortés nuni Coyoacan, nu'u̱ to'o mi pädi yojo ya jñäki ngu'a ra jerónimo aguilar ra malintzin.	ra Cuauhtémoc, Tlacotzin, ra Cihuacóatl, Oquiztzin, Panitzin, Motelhuihtzin; nuna bi sofo ra tsorés nuni Coyoacan, nu'u̱ to'o mi pädi yojo ya ɲäki ngu'a ra jerónimo aguilar ra malintzin.
t'ena ge ya macehual [ya kjä'i b'u̱i ja ra jyoya]	t'ena ge ya macehual [ya kjä'i b'ui ja ra joya]
"xki tjokuabi nuya jotjo ts'ints'u̱ mra tjuju ra ""tlauhquecho"" ne “tzinitzcan zacuan"","	"xki tjokuabi nuya hotjo ts'ints'u̱ mra tjuju ra ""tlauhquecho"" ne “tzinitzcan zacuan”,"
-¿te be'a gi mä nu'i Cihuacóatl?	-¿te pe'a gi mä nü'i Cihuacóatl?
bi k'ajni ko ya dänga ñuni nzafi ne bi tjetse ko ya makahuai nuya otomi geb'u̱ bi japi bi b'e̱di, bi mä nuyu̱:	bi k'ajni ko ya däŋga ñuni nzafi ne bi tjetse ko ya makahuai nuya otomi geb'u bi japi bi b'edi, bi mä nuyu
da tjuts'i ya nkjot'ijñä ( )	da tjuts'i ya nkjot'ijñe
da umbabije te da zi, da kjapabije nduntji ma zu.	da umbabije te da zi, da kjapabije nduntji ma zu → da umbabihe te da zi, da kjapabihe nduntji ma zu
ebu̱ bi mä nuna b'e̱fi xa tjoki xajño bi kjohya ra ts'e̱y'e̱jmu.	ebu̱ bi mä nuna b'efi xa tjo̱ki xajño bi kjohya ra ts'ey'emju.
"fernando alva ixtlilxóchitl, xiii nkjändajmä ""ra ñ'eje ya ñämfo̱ ne ra mu̱di ra joga ts'ofo ra evangelio."""	"Fernando Alva Ixtlilxóchitl, XIII nkjändajmä ""ra ñ'eje ya ñämpho ne ra mu̱di ra jogi ts'opho ra evangelio."""
ga kjuatiju̱ nu'a juts'i nkjani, ya ts'ojä'i, ra carranza, ge xa o̱t'a ya ts'okuate pa gekagiju̱; ga o̱t'e da nkja ra ts'e̱di ma munts' ne njabu̱ ga tsu̱diju̱ da nkja nu'a ra joga tsu̱tui, da nkja ra jai, ra jñegi ne ra joga ts'u̱tui;	ga kyuatihu nu'a xuts'i nkiani, ya ts'oyä'i, ra carranza, ge xa ota ya ts'okuate pa gekakiju; ga ote da nkia ra tse'di ma munts' ne ñabu ga tsudi da nkia nu'a ra yoha tsutui, da nkia ra jai, ra ñegi ne ra yoha ts'uui;
gatjo ya jyoyakjä'i mi b'u̱i ja ra jnini bi jandi.	OTQ: katjo ya joyakjä'i mi b'ui ja ra jnini bi jandi.
ja bi jäni ra ñ'udi, ma kjä'iju̱ bi ent'i gatjo majye̱gi nuya nzu̱te	ja bi jäni ra ñ'uhi, ma kjä'iju bi ent'i gatyo majyegi nuya nzute
ja n'aa nza̱tjo xudi ra pale berto, bi bo̱ni nda jyonga te nda nzimxidi ngetjo nda zi ya jme jyaxtjo mi u̱xa ya u, ua ngu mi nzäi mi nkajui yá jme nuya chukju̱ xa jogi ja nuya 'bomuja̱i nts'ät'i, nt'o̱kuä;	ja n'aa nzatjo xudi ra pale berto, bi boni nda jyonga te nda nzimxidi ngetjo nda zi ya jme jyaxtjo mi uxa ya u, ua ngu mi nza'i mi nkajui ya jme nuya chukju xa jogi ja nuya 'bomuja'i nts'at'i, nt'okuä;
ja nubia di ndäki, di ndändiñäjmu, di ma ga ts'u̱tsa'i ri y'e, ga ndäne'i ra nge'a nu'a'i ma makjaje, ra bartolomé lópez, nub'u̱ mi nkjuäni ma b'e̱jña inbi nkjuäni ja nubu̱ mi xaxi pa da o̱t'a ya tso̱mfen	ja nubia di ndäki, di ndändiñäjmu, di ma ga ts'u̱tsa'i ri y'e, ga ndäne'i ra nge'a nu'a'i ma makjaje, ra bartolomé lópez, nub'u̱ mi nkjuäni ma b'e̱jña inbi nkjuäni ja nubu̱ mi xaxi pa da o̱t'a ya tso̱mfen
ja ya t'u̱ka ze̱ki tjuts'i n'a tu̱kitjo nuna tjogi ge bi juxa ra fernando alva ixtlilxóchitl, nu'a b'e̱tsi ra xiiii nkjondajmä.	ja ya t'uka zeki tc'uts'i n'a tukitjo nuna tcogi ge bi juxa ra Fernando Alva Ixtlilxóchitl, nu'a bets'i ra xiiii nkjontajmä.
jabu̱ ga kju̱he nuyu̱ (ya tenochcas) te gi joniju̱?	jabu̱ ga kjūhe nūyu̱ (ya tenochcas) te gi jōnijū?
jam'u̱ gatjo ya kjuän'ajmä ge nuua xa ze̱ti ri ñ'eje dige'a ya noya ya mu̱dimejai ja ra jñä ya ndeznä, nuna tjuju ri uni inga se̱je̱ ra n'atsanoya pa da fädi ra jñämfo̱, ingi ri me̱udi dige'a ra jmä fu̱oti dige'a nuna ra jñäki ra netzajualtsoyotl. ne ra cuauhtémoc.	jam'u gatyo ya kyuän'ajmä ge nuua xa zeti ri ñ'eje dige'a ya noya ya mudimejai ja ra jñä ya ndeznä, nuna tjuju ri uni inga seje ra n'atsanoya pa da fadi ra jñämfo, ingi ri meudi dige'a ra jmä fuoti dige'a nuna ra jñäki ra netzajualtsoyotl, ne ra cuauhtémoc.
mi jneki ngu ma kjä'iju̱ ngabu̱ mri jneki.	mi ɟneki ŋu ma kjä'iju ŋabu mri ɟneki
nduntji bri kjojya, bri tjuxpabi gatjo nu'a mi o̱t'abi ra b'edi, ko nge'u̱ bi m'u̱i ne mi t'umbabi ya t'ixu:	nduntji bri kjojya, bri tjuxpabi gatjo nu'a mi o̱t'abi ra b'edi, ko nge'u̱ bi m'u̱i ne mi t'umbabi ya t'ixu
ngu mra me̱ti, nu'a r'a hyodi, jabu mi y'o, n'a ngu n'a mi kjohya mi mfe̱m'a xinxi xi mi kjohya ya ndäte, mi tjede n'a ngu n'a mi jñu̱fi ne mi fe̱m'a ya xinxi: xi mi b'u̱i mpaja.	ngu mra meti, nu'a r'a jodi, jabu mi yo, n'a ngu n'a mi kjohya mi mfem'a xinxi xi mi kjohya ya ndate, mi tjede n'a ngu n'a mi jnufi ne mi fem'a ya xinxi: xi mi bui mpaja.
nkjabu̱ ri ñ'eje ya kje̱ya inda m'e̱di, inda mpumfri, ga nzäi ga pe̱tsi nugagiju̱ ja ma mfeniju̱, ga pe̱tsi nugagiju̱, ra bätsi dige'u̱, ya b'e̱to, ya ntsaniku, ya mbänga b'e̱to ne to'o dra ñ'epu̱, to'o majye̱gigiju̱, ma kjiju̱, ya ku̱ju̱.	nkjabu̱ ri ñ'ehe ya kje̱ya inda m'edi, inda mpumfri, ga nzai ga petsi nugagiju̱ ja ma mfeniju̱, ga petsi nugagiju̱, ra batsi dige'u̱, ya be̱to, ya ntsaniku, ya mbanga be̱to ne to'o dra ñ'epu̱, to'o majyegigiju̱, ma kjiju̱, ya ku̱ju̱.
nu xä otj'u̱, ma gä ñ'kjäju̱	nu xä otju, ma ga ñkajju
nuga̱ xi di ne'i, jindi pädi jankja...	OTQ: nuga̱ xi di ne'hi, jindi pädi jankya...
num'u̱ di kjojyaju̱, nkueju̱, nts'o̱miju̱, tsuju ne pa da t'o̱xkäju̱ di jojñu̱ nu ya nt'u̱i xi di 'yooju̱ (¡!). nuya da nt'ot'i ko ra dänt'ot'í	num'u di kjojyaju, nkueju, nts'omiju, tsuju ne pa da t'oxkaju di jojñu nu ya nt'ui xi di 'yooju (¡!). nuya da nt'ot'i ko ra dant'ot'i
nuna bi kjojya ja ra mabagi,	OTQ: nuna bi kjoja ja ra mabagi,
nuya jñu o gojoya pa bi b'u̱i nubu̱ bi xitsuabi ra kjäpadeje nduntji ya kjä'i, ngu xa t'ena.	nuya ǵnu o gojya pa bi b'ui nubu bi xitsuaʼbi ra kjäpadeje nduntji ya kjä'i, ngu xa t'ena.
nuya tsat'io mi b'et'o, mi gu̱t'a ra ñ'u, mi teni, ya xiñu mi kju̱ts'i pa mañä, xi mi päjä gatjo mi jandi mi nest'iji: mi tu̱ta ya kjijni	nuya tsatio mi bet'o, mi gut'a ra ñu, mi teni, ya xinu mi kjuts'i pa manä, xi mi pajä gatxo mi jandi mi nest'iji: mi tuta ya kijni
pe, nu'i ndada nu'i ma t'ek'ei ra makja, nub'u̱ nu'i ingi zugagije, ¿jankja, nuua, ra jyo di ge'a, ga tsogi nubu̱ [nu'a ma b'e̱jña]?	pe, nu'i ndada nu'i ma t'ek'ei ra maksa, nub'u nu'i ingi tsugatsije, ¿yankja, nuua, ra tyo di ge'a, ga tsogi nubu [nu'a ma b'ejña]?
r'a ya kjä'i mi b'u̱i ja ra ngumi kja nunu ja ra jnini ri mankjuäntjo pa da tsoni nubu̱ ra amáxac,	r'a ya kjä'i mi b'u̱i ja ra ngumi kja nunu ja ra jnini ri mankjuäntjo pa da tsoni nubu̱ ra amáxac
ra nge'a di o̱t'a nuna noya ra ts'u̱tui ne gatjo to'o da guat'a ja ma jyoje, nu'u̱ to'o da ne, da me̱tsi n'a ra joga m'u̱i ne da m'u̱i mankjuäntjä. ja nubu̱ xa mabu̱ ma noya ge di pe̱tsi ra tsa, dega joga kjä'i ne dega jogat'o̱t'antujni	ra ngä'a di o̱t'a nuna noya ra ts'ü̱tui ne gatyo to'o da guat'a ja ma jyoye, nu'u̱ to'o da ne, da me̱tsi n'a ra joya m'ü̱i ne da m'ü̱i mankjäntjä. ja nubu̱ xa mabu̱ ma noya ge di pe̱tsi ra tsa, dega joya kjä'i ne dega joyat'o̱t'antuni
ra ngejna nuna pa bi ma n'a ra ñ'u mankjuäntjo.	ra ngëjna nuna pa bi ma n'a ra ñ'u mäkjuntjo
ra njñu ne ra ngästsi ra b'ist'ofo di juts'iju̱ ja nuna ze̱ki b'ist'ofo, ri ñ'eje ra vii nkjondajmä ra chimalpain,	ra njñu ne ra ngätsi ra b'ist'ofo di juts'iju̱ ja nuna ze̱ki b'ist'ofo, ri ñ'eje ra vii nkjondajmä ra tsimalpain,
ra ntjädi ra cuitlahuacatzin bi ena ge ina da o̱t'e nuya bi b'e̱pabi ya nso̱jo̱kjä'i,	ra ntjädi ra kuitlahuakatzin bi ena ge ina da o̱t'e nuya bi be̱pabi ya nso̱jo̱kjä'i,
ra nyojo nu'a mi zu ra tepoztlan; ra njñu ra me tizatlan, ra nkjojo mi ñ'eje nuni huehuetlan ne ra nku̱ta mra dänga mictlan.	ra ñojo nu'a mi zu ra tepoztlan; ra ñjñu ra me tizatlan, ra nkjojo mi ñ'eje nuni huehuetlan ne ra nku̱ta mra dänga mictlan.
ri ñ'udi xajño nubia jankja beni ya metlaxcala bi do̱m'i mpaja nuya nso̱jo̱ kjä'i.	ri ñudi xajño nubia jankja beni ya metlaxcala bi do̱m'i mpaja nuya nso̱jo̱ kjä'i
t'ena ge inbi unga mfädi pa gatjo ya kjä'i mi ñ'oui, ge nuna ndada ra marqués da ñ'eje dra jmu ja ma jaije, da ja me̱ti nu'a di pe̱tsije neje dra kjakagije ga mpe̱fije ra jai ge bi umbabi o bi jänbabi ya joga jai ya n'añ'o jnini.	t'ena ge inbi unga mfädi pa gatyo ya kjä'i mi ñ'oui, ge nuna ndada ra marqués da ñ'eje dra jmu ja ma jaije, da ja me̱ti nu'a di pe̱tsihe neje dra kjakagihe ga mpe̱fihe ra jai ge bi umbabi o bi jänbabi ya joga jai ya n'añ'o jnini.
xi mi taxki ra ñ'u, imbi tsa da r'anga n'a, jo̱nse̱je̱ mi taxka n'a ja ra bo̱jai. ya y'ofadi mi kju̱t'atjo.	OTQ: xi mi taxki ra ɲ'u, imbi tsa da r'anga n'a, jonseje mi taxka n'a ja ra boɲai. ya y'ofadi mi kjut'atjo.
ya dänga mfu̱nga bo̱kjä bi ntjo, bi kot'i ko ya majkjuai, mi zu̱m'i neje ko ya t'e̱nga ts'u̱t'abo̱kja.	ya däŋga mfu̱ŋa bokjä bi ndjo, bi kodi ko ya majkjua, mi zum'i nehe ko ya t'äŋga ts'ut'abokja.
ya r'atsanoya ra sajagún mi mä jankja mi yopa tsini. ya ndeznä bi nkoji inda ñ'udi. mi jatatjo pa bi mu̱di ra ntujni	ya r'atsanoya ra saxagún mi mä jankja mi yopa tsini. ya ndeznä bi nkoji inda ñ'udi. mi jatatjo pa bi mu̱di ra ntuxni
ya zi b'e̱jña mi ägi ja ya b'a ne ja ya ngo̱de, nuya ñ'o̱jo̱ mbo ja ya ne, ja ya nkjom'ajudi.	ya zi b'e̱jña mi ägi ja ya b'a ne ja ya ngo̱de, nuya ñ'o̱jo̱ mbo ja ya ne, ja ya nkjom'ajudi
bi boxro xi 'be̱ts'ina, bido'u̱ ro 'yu̱ni 'na, xi bi bo̱x ro hkjua 'na, bido'u̱ ro ts'ii 'na, xi bo̱xro ts'äre 'na. ge'bu̱ go min pu̱n doja 'na.	bi boxro xi 'bēts'ina, bido'u ro 'yuni 'na, xi bi box ro hkua 'na, bido'u ro ts'ii 'na, xi boxro ts'äre 'na. ge'bu go min pun doja 'na.
bi ma mankjuäntjo jabu̱ mi b'u̱i ra ts'e̱y'e̱jmu bi xipabi;	bi ma mankjua̱nto jabu̱ mi b'u̱i ra tse̱je̱mju bi xipabi;
bri kjuajni po nuya dra jmu.	OTQ: bri kjuni po nuya dra jmu
di to̱m'ihe ra ñ'etji pa nugagije, n'a ra pa ngu ma n'a ra pa tjogi nekagije di juadije ra nge'a indi tse̱tije nuna b'u̱i t'o̱t'e ko ngekagije man'año ya ntjo, t'e̱nts'igije tji ma jaije ma me̱tije, ju̱kagije ga mpe̱fije nduntji, b'e̱kagije ga jut'ije xduntji ya bokja, n'a ngu n'a ra pa nuna nkjut'i di o̱t'eje man'a te ma tjaije di tuje.	di tom'ije ra ñejti pa nugagije, n'a ra pa ngu ma n'a ra pa tjogi nekagije di juadije ra nge'a indi tset'ije nuna b'ui t'ote ko ngekagije man'anyo ya ntjo, tents'igije tji ma jaije ma met'ije, jukagije ga mpef'ije nduntji, bekagije ga jut'ije xduntji ya bokja, n'a ngu n'a ra pa nuna nkjut'i di oteje man'a te ma tjaije di tuje.
gatjo nuna jai ja nuna r'ayo ximjai nkjabu̱ bi tjutuabi nuya nso̱jo̱jä'i inbi tsa bi tjutuabi man'a ra tjuju.	OTQ: katjo nuna hai ja nuna r'ayo ximhai nkjabu̱ bi tcutuabi nuya nso̱jo̱jä'i inbi tsa bi tcutuabi mana ra tcuju.
ja mi tso nde, bi mu̱di bi nkja n'a ra jneki ngu nkjagiju̱ dega kjä'i, bi t'ot'e ra b'ai ngu dega kjä'i,	ja mi tso nde, bi mu̱di bi nkya n'a ra jneki ngu nkjagiju̱ dega kya'i, bi t'ot'e ra b'ai ngu dega kya'i,
ma bo̱najmu'ije: nuna b'e̱fi ga tsokagije sta kjuatihe gatjo: gi nuti nuua, xa jño bo̱najmu.	ma bonaxmu'ije: nuna befi ga tsokaxiye sta kjuatehe gatyo: gi nute nuua, xa jño bonaxmu.
mi mä dega ts'e̱dira jñä tso̱pu da ts'o̱jo̱bu nuya nzo̱jo̱kjä'i ga jandiju̱ te ma ts'e̱di pe̱tsi, ra nge'a ma akjuä ra quetzalcohuatl b'u̱i nuua ko ngekagiju̱,	mi mä dega ts'edirá jñä tso̱pu da ts'o̱jbu nuya nzo̱jkjä'i ga jandiju̱ te ma ts'edi pe̱tsi, ra nge'a ma akjua ra ketsalcoatl b'ui nuua ko ngekagiju̱,
ne ya nt'u̱i, jankja di tjuts'i ya nt'ofo, nkjap'u̱ neje mä 'ra ya mpeu̱i da fats'i di nt'ot'i ra jñäjñu	ne ya nt'ui, jankja di tjuts'i ya nt'ofu, nkjap'u neje mä 'ra ya mpeui da fats'i di nt'ot'i ra jñäjñu
nub'u̱ nu'i ingi kjapi da bo̱nga nu'a ra makja ja nu'a ra jnini, ¿jankja ra yotui, ga tso̱gi nubu̱ ma b'e̱jña? o̱t'a r'ato ya kje̱ya bi mu̱di [ra makja ra bartolomé lópez]	nub'u nu'i ingi kjapi da bo̱nga nu'a ra maksa ja nu'a ra jnini, ¿jankja ra yotui, ga tso̱gi nubu ma b'e̱jña? o̱t'a r'ato ya kje̱ya bi mu̱di [ra maksa ra bartolomé lópez]
pa ga b'u̱i mpaja ne ga o̱t'e n'a ra nkjondajmä gatjo nu'a ga jandi.	pa ga b'ui mpaja ne ga ote n'a ra nkondajmä gatyo nu'a ga jandi.
r'a nuna mi ntjandi ngu nu'a ma tjänkjuaju̱ (ychtlilmatli), xi mra nts'o, mi kuet'e ja ya ngo̱,	r'a nuna mi ntjandi ngu nu'a ma cäŋkjuaju̱ (ychtlilmatli), xi mra nts'o, mi kuet'e ja ya ŋo̱,
xa zägi mpaja, nub'u̱ xa nkjabu̱ xa kjapabi ma zu ne inte xa t'o̱tuabi nub'u̱ inda kjapi xa po̱jo̱ bi ya kue̱ ra nge'a ya kjä'i xi mra no̱t'e ne mra jyotekjä'i,	xa zägi mpaja, nub'u xa nkjabu xa kjapabi ma zu ne inte xa t'otuabi nub'u inda kjapi xa pojo bi ya kue ra nge'a ya kjä'i xi mra no̱t'e ne mra jyotekjä'i
y'o, ri ma ne gi xipabiju̱ ya metlaxcala ge ma r'a ya me̱ti kjä'i ne ri ajuäju̱, ge nu'a ga mä ge xa eje nuua ma jaiju̱, ge di umbabije ma ntjädije.	y'o, ri ma ne gi xipabiju̱ ya metlaxcala ge ma r'a ya me̱ti kjä'i ne ri ajuäju̱, ge nu'a ga mä ge xa ehe nuua ma jaiju̱, ge di umbabije ma ntjädije.
¿te da o̱t'e ma kjä'iju̱ sta b'e̱diju̱?	¿te da o̱t'e ma kjä'iju̱ sta b'eedu?
-da ts'iua:... ri ñ'eje ge'a ma nkjueij'u̱. da o̱t'eje ya ñ'o̱te ko ya je̱m'i, ya ñ'o̱t'eje ko ya ntuts'i. da o̱ts'e̱ ra b'e̱na noya.	-da c'iua:... ri ñ'ehe ge'a ma nkjueij'u̱. da o̱t'ehe ya ñ'o̱te ko ya jem'i, ya ñ'o̱t'ehe ko ya ntuts'i. da o̱ts'e̱ ra b'e̱na noya.
-dom'i ma akjuäju̱ ge inda yu̱t'a ja ma nguju̱ nuju̱ to'o e̱nts'i pa tji ne da jokuabi ra jonanjyo nub'u̱ sta ne da jyoki ya inda za.	-domi ma akwaaju ge inta yuta ja ma nugu nuju to'o ents'i pa tsi ne ta jokwabi ra jonanyo nubu sta ne ta jyoki ya inta za.
-o̱t'a ra mäte gi o̱deju̱, kja gi b'ai nuuaju̱. mont'a ya ngo akjuä; ri kjuat'i ra ngo ga tsunda ma akjuäje.	-o̱t'a ra mäte gi o̱deju̱, kja gi b'ai nuuaju̱. mont'a ya ŋgo akjuä; ri kjuat'i ra ŋgo ga tsunda ma akjuäje.
-xa jño, di b'u̱ije nkjamädije.	-xa jño, di b'uje nkjamädie.
-¿nguande nkjabu̱ ga mäu gra kjuäju̱?	-¿ngande nkjabu̱ ga mäu gra kjuäju̱?
-ñ'emabagi, ya gabida, ya kjä'iju̱ gi pädi ra ntuni ra mem'onda ba ejeju̱ ga te̱niju̱ma nzu̱teju̱. ko ya mätsa mi te̱je̱, ko ya bu̱'bai ko ngatjo ra ts'e̱di mi te̱je̱ ra ñ'u.	-ñ'embagi, ya gabida, ya kjä'iju gi pädi ra ntuni ra mem'onda ba eheju ga te̱niju̱ma nzuteju̱. ko ya mätsa mi te̱je, ko ya bu'bai ko ngatyo ra ts'e̱di mi te̱je ra ñ'u.
bi tse̱ti nuna ngot'i ra m'onda, ngu pede ra dänga b'ede, ya k'oi ne ya nkjändajmä, ngu nu'a ra jmä ra alonso axayaca, gojo n'ate ma pa bi nzo̱t'e nuna pa.	bi tseti nuna ngoti ra monda, ngu pede ra dangwa bede, ya koi ne ya njandajma, ngu nua ra jma ra alonso axayaca, gojo nate ma pa bi nzote nuna pa.
into y'o mankjuäntjo, into pa ri nektjo.	into y'o mankjuntjo, into pa ri nektjo
nub'u̱ ndi umbabije ma nkjut'ije xki nzäi ndi da'ije, mi adi n'a tu̱ki neje nub'u̱ ndi unije ya k'astaboja mi jäni made n'a tu̱ki [...]	nub'u̱ ndi umbabije ma nkjut'ije xki nzäi ndi da'ije, mi adi n'a tu̱ki neje nub'u̱ ndi unije ya k'astaboja mi jäni made n'a tu̱ki [...]
ya miñ'o ko ngejna jmä ri kjojya,	ya miñ'o ko ńejna jmä ri kjojya,
bi tso̱jso̱ ra ngo ma akjuäju̱: nubia da fu̱di da guadi ra r'e̱t'a ra pa.	bi c'o̱jso̱ ra ŋgo ma akjua̱ju̱: nubia da fudi da gwadi ra r'eta ra pa.
