INALI	OTS
"-pasadores: ""ya nts'äza xi mra nts'u̱t'i mi t'e̱ni ko n'a ra t'e̱nga ts'u̱t'a bo̱ja mi thutuabi ra ballesta""."	"- pasadores: ""ya ntza xi mra ntut'i mi teni ko na ra tengatsa tsuta boja mi tutuabi ra ballesta""."
cantares mexicanos, biblioteca nacional de méxico, ya nt'ofo 1628 bis, folio 16 v.	Cantares mexicanos, biblioteca nacional de méxico, ya nt'ofó 1628 bis, folio 16 v.
"ebu̱ bi bo̱ni, bi meui nuni nonohualco, ha ra ngu ra b'ongui habu̱ ra gabida ne ra malintzin ne ""ra hyadi"" (alvarado) ne ra sandoval."	"ebu bi bōni, bi meui nuni nonohualco, ha ra ngu ra b'ongui habu ra gabida ne ra malintzin ne ""ra hyadi"" (alvarado) ne ra sandoval."
gi handi ra nt'ofo ra thuhu ra crónicas de la conquista	gi handi ra nt'oho ra thuhu ra crónicas de la conquista
guzmán. ha ya he̱m'i b'e̱tsa je̱ya manteb'u̱ di ge nuua m'onda ne ya hyo, nu'a ra hmä ra 12-conejo (1530) ge xa hmä ge xibú bi yut'i ha ra culhuacan ya ndeznä, nda pablo xochiquetzin, motelchiuhtzin ne ra guzman.	guzmán. ha ya hem'i b'etsa jeya manteb'u di ge nuua m'onda ne ya hyo, nu'a ra hmä ra 12-conejo (1530) ge xa hmä ge xibú bi yut'i ha ra culhuacan ya ndeznä, nda pablo xochiquetzin, motelchiuhtzin ne ra guzman.
ha ga ñ'udihu̱ ra nt'ofo ya ñämfo̱ po ra nthuts'i ra doctor garibay,	ha ga ñ'udihu ra nt'ofo ya ñämfo po ra nthuts'i ra doctor garibay
ha nu'a hyodi nubia thutuabi ra san martin.	ha nu'a hyodi nubia thutuabi ra san martin
he̱mi unga mfädi ha ra t'u̱ka hnini habu̱ b'u̱i ya jä'i teni ra división ra arenas, 27 ra abril ra je̱ya 1918, ra m'ets'a he̱m'i ra zapata, b'e̱tsi ha ra universidad nacional autónoma de méxico, expediente 29.	he̱mi uŋga mfädi ha ra t'u̱ka hnini habu̱ b'u̱i ya jä'i teni ra división ra arenas, 27 ra abril ra je̱ya 1918, ra m'ets'a he̱m'i ra zapata, b'e̱tsi ha ra universidad nacional autónoma de méxico, expediente 29.
"m'e̱fa ha ra hñuti bri thätuabi na ra hñe xki tagiri mo̱te, nehe bri jom'a ra xu̱tha ko n'a ra t'axa dutu mra thuhuu ra ""campanillante""."	"m'efa ha ra hñuti bri thätuabi na ra hñe xki tagiri mo̱te, nehe bri jom'a ra xu̱tha ko n'a ra t'axa dutu mra thuhuu ra ""campanillante""."
ma dada'ihe gra ts'u̱tui, di ne gi pädi ge ma me̱t'o instä thogihe nuna thogi gatho ya mapa xki r'ani, bi juat'i ko ngeke nu̱'u ri b'e̱go, ri me̱fi ya ñämfo̱, ra nge'a majuäni ra hernando cortés ra ndä gabida,	ma dada'ihe gra ts'utui, di ne gi pädi ge ma met'o insta thogihe nuna thogi gatho ya mapa xki r'ani, bi juat'i ko ngeke nu'u ri b'ego, ri mefi ya ñamfo, ra nge'a majuäni ra hernando cortés ra nda gabida
mi b'u̱i ya mu̱dimehai mi ñä ra ndeznä ne habu̱ ra hnini dige'a gatho ra nxiki m'onda ngu r'a ya yaqui b'u̱i nuni sonora ne ya maya ri ñ'ehe nuni yucatán ra nge bi guat'i ha ra tuhni bi nja nuua m'onda fädi ko ra thuhu ra revolución mexicana ya je̱ya 1910-1919.	mi bui ya mudimehai mi ñä ra ndeznä ne habui ra hnini digea gatho ra nxiki m'onda ngu r'a ya yaqui bui nuni sonora ne ya maya ri ñ'ehe nuni yucatán ra nge bi guati ha ra tuhni bi nja nuua m'onda fädi ko ra thuhu ra revolución mexicana ya jeiya 1910-1919.
mi fo̱tuabi ya ts'u̱tnibo̱ja mi thutuabi ya hñämfo̱ ra pasadores nehe ya bo̱zna ko ya nzafi.	mi fo̱tuabi ya ts'u̱tnibo̱ja mi thutuabi ya hñämfo̱ ra pasadores nehe ya bo̱zna ko ya nzafi.
n'a nt'udi di ge'a nuya nthoki bri t'o̱t'e ha ya hñä ya ndeznä ra ngätsi ra nthebe nje̱ya ra r'e̱t'a ma gu̱to (s. xix), r'a ya hnini ngu ra xicontepec (villa juárez) nuna hyodi kohi nuni puebla.	n'a nt'udi di ge'a nuya nthoki bri t'o̱t'e ha ya hñä ya ndeznä ra ngätsi ra nthebe nje̱ya ra r'e̱t'a ma gu̱to (s. xix), r'a ya hnini ngu ra xicontepec (villa juárez) nuna hyodi kohi nuni puebla
"n'a ra t'axa dutu mi pe̱tsi ya k'oi ra ixki, nuna mra thuhu hñämfo̱ ""campaneante resonador""."	"n'a ra t'axa dutu mi pe̱tsi ya k'oi ra ixki, nuna mra thuhu hñämfo̱ ""campaneante resonador""."
ne ri mpe̱fi ha ra dängan gu nt'udi ra thuhu ra facultad de estudios superiores, acatlán, unam,	ne ri mpe̱fi ha ra dangang gu nt'udi ra tuhu ra facultad de estudios superiores, acatlán, unam
nthandi gatho nu'a ra munts'i ra thuhu hñämfo̱ ra globalización ge 'a po̱ts'e dega nest'ihi, nuna y'o̱te to̱m'i da nja ra ntho̱mäte.	nthandi gatho nu'a ra munts'i ra thuhu hñämfo ra globalización ge 'a po̱ts'e dega nest'ihi, nuna y'o̱te to̱m'i da nja ra ntho̱mäte
nu'a ma r'a ya jä'i mi pädi nuña b'e̱fi bri b'e̱pabi xa hyoki yoho ya mpe̱fi mi fädi ko ra thuhu ra amosqueador ko ya xi ya ts'ints'u̱ xi sta hotho, gi hutsuabi made dige'a n'a ra zänä dega k'astaboja	nu'a ma r'a ya jä'i mi pädi nuña b'efi bri b'epabi xa hyoki yoho ya mp'efi mi fädi ko ra thuhu ra amosqueador ko ya xi ya ts'ints'u xi sta hotho, gi hutsuabi made dige'a n'a ra zänä dega k'astaboja
"nu'a ra munts'a jä'i bi te̱ni bi zipabi man'a ya b'ede, mi t'ena ge ya jä'i xki b'u̱i nubu̱ inbi pe̱tsi ra ts'e̱di nu'a mi mä pe m'e̱fa bi japi bi nxaxni ya tsu̱tui ne n'a ra diputado mi pe̱tsi ra mfeni xki kot'i mra thuhu ra josé maría lozano, bi y'onga ra hmä pa mar'a ya ñ'oui bi nxanxi: ""ri mo̱te ra thits'i mi udi ra emiliano zapata, nehe bri fädi ngu ra atila nuna bri nju̱tsi [...] nu'a bi fädi ngu mi he̱gi ya b'e̱go ne'a bi mä da uni da nja pa gatho, ingi jot'i [...]"	"nu'a ra munts'a jä'i bi te̱ni bi zipabi man'a ya b'ede, mi t'ena ge ya jä'i xki b'u̱i nubu̱ inbi pe̱tsi ra ts'e̱di nu'a mi mä pe m'e̱fa bi japi bi nxaxni ya tsu̱tui ne n'a ra diputado mi pe̱tsi ra mfeni xki kot'i mra thuhu ra josé maría lozano, bi y'onga ra hmä pa mar'a ya ñ'oui bi nxanxi: ""ri mo̱te ra thits'i mi udi ra emiliano zapata, nehe bri fädi ngu ra atila nuna bri nju̱tsi [...] nu'a bi fädi ngu mi he̱gi ya b'e̱go ne'a bi mä da uni da nja pa gatho, ingi jot'i [...]."
nu'u̱ to'o ñä ra ndenzä ha r'e̱t'a ma r'at'o ya estados.	nu'u to'o ñä ra ndenzä ha re̱t'a ma rat'o ya Estados.
nub'u̱ ri m'e̱hni ne ri b'e̱go ya ñämfo̱ bi juat'i ko ngekagihe ne bi tso̱ho̱ ra gabida ra thuhu ra hernán cortés, maske indi pädihe ge gatho da za da o̱t'e ne xi ra nzunda maría trinidad,	nub'u ri m'ehni ne ri b'ego ya ñamfo bi juati ko ngekagihe ne bi tsoho ra gabida ra thuhu ra hernán cortés, maske indi pädihe ge gatho da za da o't'e ne xi ra nzunda maría trinidad
nubia, unga mfädi ha ra ñähñu jamädi ra universidad autónoma del estado de hidalgo.	nubia, unga mfädi ha ra ñähñu jamädi ra universidad autónoma del estado de hidalgo
nugi, ra miguel hernández ge di pe̱tsi ma ngu nuni chiyauhtzinco, ko ra t'ek'ei di udi ko nge'i, nuna m'e̱hnant'ofo di hoki go tso̱n'i ko nge'i, ma t'ek'ei bo̱nahmu'i nda doctor alonso ruiz, ra nk'ohnate ge gi b'ui nuua ha ra hnini ra quamochtitla.	nugi, ra miguel hernández ge di pe̱tsi ma ngu nuni chiyauhtzinco, ko ra t'ek'ei di udi ko nge'i, nuna m'e̱hnant'ofo di hoki go tso̱n'i ko nge'i, ma t'ek'ei bo̱nahmu'i nda doctor alonso ruiz, ra nk'ohnate ge gi b'ui nuua ha ra hnini ra quamochtitla
nuna he̱m'i bri t'unga mfädi ko ra t'u̱ka nthint'ant'ofo po ra marcelo díaz salas ne ra luis reyes garcía ha: tialtocan, revista de fuentes para el conocimiento de las culturas indígenas de méxico, vol. vi, 1970, b'ede ra 3, pp. 193-212.	nuna hem'i bri tunga mfa̱di ko ra tu̱ka nthint'ant'ofo po ra Marcelo Díaz Salas ne ra Luis Reyes García ha: Tialtocan, Revista de fuentes para el conocimiento de las culturas indígenas de México, Vol. VI, 1970, b'ede ra 3, pp. 193-212.
"nuna hñäpi huts'i ha n'a ra he̱m'i fädi ra derecho canonigo ko ra thuhu hñämfo̱ ngu ra ""solicitación al administrar el sacramento de la confesión""."	"nuna hñäpi huts'i ha n'a ra he̱m'i fädi ra derecho canonigo ko ra thuhu hñämfo̱ ngu ra ""solicitación al administrar el sacramento de la confesión""."
nuna m'e̱hna nt'ofo b'e̱tsi ha ra archivo histórico nacional, madrid, documento 165. bi unga mfädi ha ra nt'ofo ya zubi po ra y'ofo ra thuhu ra arthur j. o. anderson et al.: byond the codices: the nahua view of colonial mexico, berkeley, university of california press, 1976, pp. 181-187.	nuna m'ehna nt'oho b'etsi ha ra archivo histórico nacional, madrid, documento 165. bi unga mfadi ha ra nt'oho ya zubi po ra y'oho ra thuhu ra arthur j. o. anderson et al.: byond the codices: the nahua view of colonial mexico, berkeley, university of california press, 1976, pp. 181-187.
nuna nt'ofo b'e̱tsi ha ra archivo general de indias, sevilla, audiencia de méxico 168, bi unga dra fädi po ra miguel león-portilla ha cultura en peligro, méxico, alianza editorial mexicana, 1976, pp. 102-103.	nuna nt'ofu b'ätsi ha ra archivo general de indias, sevilla, audiencia de méxico 168, bi unga dra fädi po ra miguel león-portilla ha cultura en peligro, méxico, alianza editorial mexicana, 1976, pp. 102-103.
nuna pika he̱m'i ja te mä b'e̱tsi ha ra archivo general de la nación, nuua m'onda ne ja ha ra ndunthi ya hnini, njabu̱ ngu ya nzaya nuni manhyati ne mar'a ya hnini, o̱t'e gi o̱de ra hñä ra mu̱dimehai.	nuna pika hem'i ja te mä b'etsi ha ra archivo general de la nación, nuua m'onda ne ja ha ra ndunthi ya hnini, njabu ngu ya nzaya nuni manhyati ne mar'a ya hnini, ote gi ode ra hña ra mudimehai.
nuua t'unga yoho ya hmä, kuän'ahmä ya ndeznä ne thuts'i ha n'a ra k'oi mä mäjuäni ri nthe̱ui n'a ya dänga ra thu̱ahmä manteb'u̱, nuua pede nu'a gatho ya ts'othogi bi y'o̱t'a dega fete ra alvarado.	nuua t'unga yoho ya hmä, kuän'ahmä ya ndeznä ne thuts'i ha n'a ra k'oi mä mäjuäni ri nthe̱i n'a ya dänga ra thu̱ahmä manteb'u̱, nuua pede nu'a gatho ya ts'othogi bi y'o̱t'a dega fete ra Alvarado.
nuua ya mu̱di noya ra motolinia, ha ra mu̱di nkohi bi t'o̱t'e ko ra thuhu ra tratado tercero ra dänga b´ede ya mu̱dimehai nuua r´ayo manhyati:	OTS: nuua ya mudi noya ra motolinia, ha ra mudi nkohi bi t'ote ko ra tuhu ra tratado tercero ra dangabe de ya mudimehai nuua r'ayo manhyati
"pa da t'unga mfädi gatho nu'u̱ bi nja, n'a di ge'u̱ ko ngu fe̱ti nu'a majuäni mi hoki mi thutsuabi ya hnei ne ya b'ida. b'u̱i man'a ra mfädi da t'o̱t'a ra nt'udi, nu'a ra thuhu ""fe̱ta nu'a majuäni bi nja nub'u̱ ra tsokat'o̱tamfeni (teatro de la conquista)""."	"pa da t'unga mfädi gatho nu'u bi nja, n'a di ge'u ko ngu fe̱ti nu'a majuäni mi hoki mi thutsuabi ya hnei ne ya b'ida. b'u̱i man'a ra mfädi da t'o̱t'a ra nt'udi, nu'a ra thuhu ""fe̱ta nu'a majuäni bi nja nub'u̱ ra tsokat'o̱tamfeni (teatro de la conquista)""."
ra europa -mra nxika hai manteb'u̱, mi pe̱tsa n'a ra nxika b'ede-	ra europa -mra nxika hai manteb'u, mi pe̱tsa n'a ra nxika b'ede
ra fernando ramírez mä ge nuna hyodi ri nge̱pu̱ habu̱ ja n'a ra nija ra san fernando ne ra ermita dige'a ya mártires dige'a san hipólito,	ra fernando ramírez mä ge nuna hyodi ri ngëpu habu ja n'a ra nija ra san fernando ne ra ermita dige'a ya mártires dige'a san hipólito
"ra fernando de alva ixtlilxóchitl, fernando de, xiii relación: ""ra ñ'ehe ya ñämfo̱ ne ra fu̱di ra nkanfri ra evangelio""."	"ra fernando de alva ixtlilxóchitl, fernando de, xiii relación: ""ra ñehe ya ñämbo̱ ne ra fu̱di ra nkanfri ra evangelio""."
ra kuän'ahma ra n luz jiménez bi huts'i ra fernando horkasitas bi unga mfädi ne bi r'atsi nuña hmä), de porfirio díaz zapata, memoria nábuatl de milpa alta, méxico, unam,, instituto de investigaciones históricas, 1974, p. 105	ra kuän'ahma ra n luz jiménez bi huts'i ra fernando horkasitas bi unga mfädi ne bi r'atsi nuña hmä), de porfirio díaz zapata, memoria nábuatl de milpa alta, méxico, unam, instituto de investigaciones históricas, 1974, p. 105
ra raymundo isidro alavez, bi b'u̱i'i nuni ra boxtha chico, san salvador, estado de hidalgo	ra raymundo isidro alavez, bi b'u̱i'i nuni ra boxtha chico, san salvador, estado de hidalgo
ra hmä ra fundación de santo tomás ajusco, archivo general de la nación, méxico, ramo de tierras vol. 2676, expediente. 4, archivo histórico de la biblioteca nacional de antropología, colección antigua, vol. 254, fojas 259 r.- 260 v.	ra hmä ra fundación de santo tomás ajusco, archivo general de la nación, méxico, ramo de tierras vol. 2676, expediente. 4, archivo histórico de la biblioteca nacional de antropología, colección antigua, vol. 254, fojas 259 r.- 260 v.
ra makja mra thuhu ra toribio benavente, motolinia,	ra makya mra tuhu ra toribio benavente, motolinia
tlauhquechol: ra ts'ints'u̱ xa ntheni pode ge'a ra flamenco o ra guacamaya, pode ge gatho ra the̱nga ts'ints'u̱ ne dänga.	tlauhkechol: ra ts'ints'u xa ntheni pode ge'a ra flamenco o ra guacamaya, pode ge gatho ra thega ts'ints'u ne dangga
xkri tso̱ngä ngosthi, ja hehni ya 'ñu; nä'ä rí ma nxamädo, ha nä'ä rí ma mäbo̱za. antes de	xrí tso̱ngä ngosthi, ja hehni ya 'ñu; nä'ä rí ma nxamädo, ha nä'ä rí ma mäbo̱za
ya b'e̱go ne ya b'e̱tri di ge'a nu'a ra dänga ndä ra ndada ra thuhu ra esteban de guzmán ra nzaya di gekua m'onda, ra ndada ra hernando pimentel, ra ndada ra antonio cortés, ra ndada xuua (juan) nuna ra mecoyoacan, ra ndada pedro motecuhzoma, me ma r'a ya kuänmi (firmas).	ya b'ego ne ya b'etri di ge'a nu'a ra dangga nda ra ndada ra tuhu ra Esteban de Guzmán ra nzaya di gekua m'onda, ra ndada ra Hernando Pimentel, ra ndada ra Antonio Cortés, ra ndada xuua (Juan) nuna ra Mecoacan, ra ndada Pedro Motecuhzoma, me ma r'a ya kuänmi (firmas).
ya kuän' ahmä xa thogi manteb'u̱e ge xa thäst'i nu'a gatho ra nthandi to'o bi b'e̱di ge xa pu̱ngahñä nuna hmä getbu̱ n'ate ya hñäki ge ñä ya nso̱ho̱ hñäki ne xa y'oni nuna nt'ofo nehe ha ra hñäki yazi xada jä'i , ge'a nuna hñäki fadi ha ra hñämfo ko ra thuhu ra sistema braile.	ya kuän' ahmä xa thogi manteb'u̱e ge xa thäst'i nu'a gatho ra nthandi to'o bi b'e̱di ge xa pu̱ngahñä nuna hmä getbu̱ n'ate ya hñäki ge ñä ya nso̱ho̱ hñäki ne xa y'oni nuna nt'ofo nehe ha ra hñäki yazi xada jä'i , ge'a nuna hñäki fadi ha ra hñämfo ko ra thuhu ra sistema braille.
ya r'atsanoya ra sahagán, ndoxjua k'oi florentino, lib. xii, caps. xxix-xli (versión de ángel ma. garibay k.).	ya r'atsanoya ra sahagán, ndoxjua k'oi florentino, lib. xii, caps. xxix-xli (versión de ángel ma. garibay k.).
despwés ya desde k'a ra momento ya k'a ya híngi bénya'wi já té bimáhhu̱ k'a ra charroya'wi	despwés ya desde k'a ra momento ya k'a ya híngi bénya'wi já té bimáhhu̱ k'a ra charroya'wi
despwés ya xo bimu̱fí pe xo diario diario bu̱ nchúi mitsu̱ k'a ra charro mi'óbí k'a ra mikwála	despwés ya xo bimufí pe xo diario diario bu nchúi mitsu k'a ra charro mi'óbí k'a ra mikwála
gopareháhé primero 'á k'a ra parte ánk'ú dínant'í	goparehahé pimero 'á k'a ra párte ánk'u dinant'i
i asta fecha pues ignoro mucho pero másk'ŭ mäjámá más ndímáignorahéwi	i asta fecha pues ignoro mucho pero másk'ŭ mäjámá más ndímáignorahéwi
indu̱odiagí bastante	indu̱odiagí bastánte
inga se̱he̱ ra nnthandi ra manhyati ne ra portuguesa nehe ra francesa, inglesa, alemana e italiana,	inga sehe ra nthandi ra manhyati ne ra portuguesa nehe ra francesa, inglesa, alemana e italiana
k'a mädämé para ke mantenigíhé dígothó mäbähtsí pues ni modo dísufréhé	k'a mädämé para ke mantenigíhé dígothó mäbähtsí pues ni modo dísufréhé
kómá'u̱té ya fuente níhí	kómá'u̱té ya fuente níhí
ne bi unbabi ndunthi ya baba, bi enbabi ge mi ne da ñäui ra ndä (emperador) mi b'u̱i nuni manhyati, ne da häni ra dänga ts'ofo ra evangelio,	ne bi umbabi ndunthi ya baba, bi enbabi ge mi ne da ñäui ra ndä (emperador) mi b'ui nuni manhyati, ne da häni ra dänga ts'ofo ra evangelio
normalmente góho	normalmente góhó
panteón ga dó	panteón ga ndó
pero de sesenta pantsíthá pa gothók'ŭ kompletamente xathó ndímáfădihé	pero de sesenta pantsitha pa gothok'u kompletamente xatho ndimafadihe
pero eso sí binúhgí mängŭhé kada ná	pero eso sí binuhgi manguhe kada na
"po nuya ja'i to'o mi pede ge fädi ko ra thuhu ya ""cronistas de las indias"""	"po nuya ja'i to'o mi pede ge fädi ko ra thuhu ya ""cronistas de las indias"""
pues este kábádá balewa este mínimo siento sinkwenta	pues este kabada balewa este minimo siento sinkuenta
pues nimodo bisufré k'a más ante mäabwelitahé komo mbu̱i enkahoso ra ntsoya	pues nimodo bisufré k'a más ante mäabwelitahé komo mbu̱i enkahoso ra ntsoya
ra nku̱t'i ra huahni ne ya ñ'udi nthutsi ra agustin yáñez 2da. edición. biblioteca del estudiante universitario, unam, 1950.	ra nkut'i ra huahni ne ya ñ'udi nthutsi ra Agustín Yáñez 2da. edición. Biblioteca del Estudiante Universitario, UNAM, 1950.
solamente ya riko alkansabi	solamente ya riko alkansavi
xi ra tí na ta komedór 'á itsí na ta alimento k'a ra ndăni	xi ra tí na ta komedor 'á itsí na ta alimento k'a ra ndani
xo mitahá ra ntsoya mitá sínko pesos ra béhña dos sinkwenta	OTS: xo mitahá ra ntsoya mitá sinko pesos ra béhña dos sinkuenta
xo taja mä sesenta wik'a taja mä sesenta bitahkíhéya'wik'a	xo taya mä sesenta wik'a taya mä sesenta bitaxkihéya'wik'a
á panteón ga dó níhí	á pántiun ga dó níhí
ñúdigehña dabadihíya' razo''ya' mientra más dandu̱hté	ñúdigehña dabadihíya' razo''ya' mientra má' dandu̱hté
-nu'u̱ dige'u̱ b'u̱i nuni maxey (tolimán ne amealco), dige'u̱ temoaya nuni ra ra hyodi estado de méxico ne mar'a ya hyodi nuni puebla ne veracruz	- nu'u dige'u bui nuni maxei (tolimán ne amealco), dige'u temoaya nuni ra ra hyodi estado de méxico ne mar'a ya hyodi nuni puebla ne veracruz
ne mätahekitho di ja getbu̱, ra hñäpi ra joel martinez hernández ne ra hotho thuahmä ra natalio hernández xocoyotzin, nuya yoho ya xahnate ri ñ'ehe ya y'u̱ dige'u̱ ya ndeznä.	ne mätahekitho di ja getbu, ra hñäpi ra joel martinez hernández ne ra hotho thuahmä ra natalio hernández xocoyotzin, nuya yoho ya xahnate ri ñ'ehe ya y'u dige'u ya ndeznä.
"-n'ate pa n'a ra zänä de ra r'e̱t'a ma hñäto ""zänä"" mi zo̱ta ya munts'i ya n'ate ya pa ge mi hoki ra xihuitl o ""ra m'ede ra je̱ya"""	"-nt'ate pa n'a ra zänä de ra r'et'a ma hñäto ""zänä"" mi zo̱ta ya munts'i ya nt'ate ya pa ge mi hoki ra xihuitl o ""ra m'ede ra je̱ya"""
bi ma di gepu̱ ham''u̱ ra ngo pa da ts'ithe ya it'adehe (Tlahuano) ba po̱ni nubu̱ tlapechhuan. mra ngo ra Izcalli.	bi ma di gepu ham'u ra ngo pa da ts'ithe ya it'adehe (Tlahuano) ba poni nubu tlapechhuan. mra ngo ra Izcalli
bi mu̱di da hyoka ya t'u̱kats'u̱fabo̱ja. ge'a ra ntuhni bi nja nuni Coyohuehuetzin ne ma goho ba nja.	OTS: bi mu̱di da hyoka ya t'u̱kats'u̱fabo̱ja. ge'a ra ntuhni bi nja nuni Coyohuehuetzin ne ma goho ba nja
bri tho ra cuauhnochtli, ra gabida tlacatecco, ra cuapan, ra gabida huitznáhuac, ra makja Amantlan, ne ra makja tlacopan.	bri tho ra kuañoxtli, ra gabida tlakateko, ra kuapan, ra gabida witznáwak, ra makya Amantlan, ne ra makya tlakopan.
bri ts'u̱tuabi ha ra y'u̱ga n'a ra nto̱de dega t'u̱ka hoga do dega chalchihuite: made mi huts'i n'a ra tsant'i dega k'astaboja.	bri ts'utuabi ha ra yu'ga n'a ra ntode dega t'uka hoga do dega chalchihuite: made mi huts'i n'a ra tsant'i dega k'astaboja
Castañeda, ra t'u ra Aquiyahualcatecuhtli, m ra ndä nuni tlaxcala.	Castañeda, ra t'u ra Aquiyahualcatecuhtli, m ra ndä nuni tlaxcala.
Coaíhuitl mra gabida ndeznä nuya mapa digeá ra t'o̱t'ats' okamfeni.	Coaíhuitl mra gabida ndeznä nuya mapa digeá ra t'ot'ats' okamfeni.
di gepu̱ ba koi pa nuni ra Xochimilco. nubu̱ ba tu ya jä'i ya metlatelolco	OTS: di gepu ba koi pa nuni ra Xochimilco. nubu ba tu ya jä'i ya metlatelolco
ebu̱ ba ehe man'aki ba te̱nga ra t'o̱ho̱ ra thuhu ra Citlaltépec. Tlacopan, nubia ba o̱t'ra b'u̱i ha ra ndo̱m'ihmu.	OTS: Ebu ba ehe man'aki ba te̱nga ra t'o̱ho̱ ra thuhu ra Citlaltépec. Tlacopan, nubia ba o̱t'ra b'u̱i ha ra ndo̱m'ihmu.
ebu̱ bi dädi ra Cihuacóatl:	ebu bi dädi ra Cihuacóatl
ebu̱ bi ñä ra Cuauhtémoc bi xipabi ra Cihuacóatl:	ebu bi ñä ra Cuauhtémoc bi xipabi ra Cihuacóatl
goho n'ate ya pa ne ebu̱ bi yopa bo̱ni pa di mani ra Huaxtepec, ra Cuauhnahuac (Cuernavaca).	goxo n'ate ya pa ne ebu bi yopa bo̱ni pa di mani ra Huaxtepec, ra Cuauhnahuac (Cuernavaca).
gue dá nhuat'i mbo ja ra ximhai,	gue dá ñuat'i mbo ja ra ximhai
i nte ra nge'a, ya hmä huts'i ha ra ndäxjua k'oi ra códice ra ramírez uni nuna b'e̱de mä majuäni ngu mä ra nthe̱ka b'ede ne ra ndädi nu'a ra nänä mra thuhu ra yacotzin, ra nänä ra ixtlilxóchitl,	i nte ra ngä'a, ya hmä huts'i ha ra ndäxjua k'oi ra códice ra ramírez uni nuna b'e̱de mä majuäni ngu mä ra nthe̱ka b'ede ne ra ndädi nu'a ra nänä mra thuhu ra yacotzin, ra nänä ra ixtlilxóchitl
inda hyo ko ra ndäxjua ixtlilxóchtil, ra dada ra Nezahualcóyotl ni ko ra fernando de alva ixtlilxóchitl.	inda hyo ko ra ndäxjua ixtlilxóchtil, ra dada ra Nezahualcóyotl ni ko ra Fernando de Alva Ixtlilxóchitl.
k o ya bu̱' bai, ko ya makahuai,	k o ya bu̱' bai, ko ya makahuai
mi fudi da t'axka ra xudi ba ts'i, bri thát'a ha n'a ra za mi b'ai ha ra ngu ra Ahuizotzin nuni ra Acatliyacapan.	mi fudi da t'axka ra xudi ba ts'i, bri thát'a ha n'a ra za mi b'ai ha ra ngu ra Ahuizotzin nuni ra Acatliyacapan
mi gu̱t'a ra ñ'u̱ n'a ra makja ge'a mra b'e̱fi mi zu nu'a ra mäka hai mra thuhu ra Yohualichan.	mi gu̱t'a ra ñ'u̱ n'a ra makya ge'a mra b'e̱fi mi zu nu'a ra mäka hai mra thuhu ra Yohualichan
mi y'o y'oua, mi tuts'i ya bu̱'bai dega za, ne r'a mi hä dega bo̱ja ne ya mahuai.	mi y'o y'oua, mi tuts'i ya bu̱'bai dega za, ne r'a mi hä dega bo̱ja ne ya mahuai
mra ngu ra Aztautzin ge'a mi ja getbu̱ nuni ra Amáxac.	mra ngu ra Aztautzin ge'a mi ja getbu nuni ra Amáxac
n'a ra hyo ne man'a bi xokuabi ra debi. ra Cuauhtemoctzin bri xokuabi ra debi ge'a se̱he̱.	n'a ra hyo ne mana bi xokua'bi ra debi. ra Cuauhtemoctzin bri xokua'bi ra debi ge'a sehe.
ne m'e̱fa bi ma xki häki ya he dega magabi, ñätsi bi ntsaya ra mahuai ne ra bu̱'bai, bri njonda ya bo̱nahmu nuni Acachinanco.	ne m'efa bi ma xki haki ya he dega magabi, ñatsi bi ntsaya ra mahwai ne ra bu'bai, bri njonda ya bonahmu nuni Acachinanco.
ne njabu̱ bri t'ot'e nehe ko mar'a ya bo̱nahmu mi pe̱tsi ra t'u̱ka tsu̱tui ha ya t'u̱ka hnini, nuyu̱ to'o mi b'e̱pi da t'o̱t'e ngu nuni Xalapan, Tlaxcalan, Tehuantepec, Oaxaca nehe mar'a ya bo̱nahmu mar'a ya t'u̱ka hnini habu̱ bi guat'i ya nduste, ya dumanthuhu dega k'astaboja, ge ya thuhu ya kristiano [...]	ne njabu bri t'ot'e nehe ko mar'a ya bonahmu mi petsi ra t'uka tsutui ha ya t'uka hnini, nuyu to'o mi bepi da t'ot'e ngu nuni Xalapan, Tlaxcalan, Tehuantepec, Oaxaca nehe mar'a ya bonahmu mar'a ya t'uka hnini habu bi guati ya nduste, ya dumanthuhu dega k'astaboja, ge ya thuhu ya kristiano
ne nu'a ri däme, pu̱ ñ'a'i, nugi ga ma ga tsogi'i nuni Cuetlachcoapan [n'a ra hnini nuni puebla],	ne nu'a ri däme, pu ñ'a'i, nugi ga ma ga tsogi'i nuni Kuetlachkoapan [n'a ra hnini nuni Puebla].
ne nu'u̱ bi mani dra ts'okat'o̱t'amfeni nuni Michoacán, Xalisco, Culhuacan ne nuni nehe Pánuco, ne nuni Oaxaca, Tehuantepec ne Guatemala, ne nuua ra r'ayo mahyati, nub'u̱ bri t'o̱t'a ra mabagi pa dra uadi dra t'o̱t'a nu'a ra ts'okat'o̱t'amfeni inda tsogihe se̱he̱.	ne nu'u bi mani dra ts'okat'o̱t'amfeni nuni Michoacán, Xalisco, Culhuacán ne nuni nehe Pánuco, ne nuni Oaxaca, Tehuantepec ne Guatemala, ne nuua ra r'ayo mahyati, nub'u bri t'o̱t'a ra mabagi pa dra uadi dra t'o̱t'a nu'a ra ts'okat'o̱t'amfeni inda tsogihe se̱he̱
nehege'a ra ngätsi. mi hä ya mpe̱fi dega mabagi,ya njom'a te ne ya fu̱nbo̱ja, inte ma mahuai mi hä ni ge'a ya bu'bai.	nehege'a ra ngätsi. mi hä ya mpe̱fi dega mabagi, ya njom'a te ne ya fu̱nbo̱ja, inte ma mahuai mi hä ni ge'a ya bu'bai
njabu̱ bi bo̱nga dega xui. mra ngo nub'u̱ ra Tecuílhuitl bi bo̱nga: nub'u̱ bi ja ya du ha ra r'ani ra dehe ya u̱erna.	OTS: njabu bi bonga dega xui. mra ngo nub'u ra Tecuílhuitl bi bonga: nub'u bi ja ya du ha ra r'ani ra dehe ya uerna.
nub'u̱ bi thandi ra Tzihuacpopoca, bi t'ena:	nub'u bi thandi ra Tzihuacpopoca, bi t'ena
nub'u̱ ya ñämfo̱ bi handi ge xa ñ'ehe nubu̱ da tsu̱di, ge mi tekuabi ra nest'ihi, m'estho bi munts'i bi mihi ya mahuai.	nub'u ya ñämfo bi handi ge xa ñ'ehe nubu da tsu̱di, ge mi tekuabi ra nest'ihi, m'estho bi munts'i bi mihi ya mahuai
nuna jä'i inbi tsa bi thädi majuäni nu'a ra nt'ani. ingra nge'a nuya pa bi hneki n'a ra hyoya jä'i ra macehual (hombre de pueblo),	nuna jä'i inbi tsa bi thädi majuäni nu'a ra nt'ani. ingra nge'a nuya pa bi hneki n'a ra hyoya jä'i ra masehual (hombre de pueblo),
nuna nte̱nga b'ede ha bri hat'i ra Tzihuacpopocatzin, bi o̱t'e da thogi ge'a ra ts'e̱y'e̱hmu. inbi bo̱nga nuna nt'o̱t'e bi tsu̱dihu̱ ko ma r'a ya b'e̱hni. ma ra ya ñ'ete inbi hopi da ju̱ man'aki ra ñ'u nuya ts'okate. pe nuya inbi hoki ra b'ai.	nuna ntenga b'ede ha bri hat'i ra Tzihuacpopocatzin, bi ote da thogi ge'a ra tseyemhu. inbi bonga nuna nto'te bi tsudihu ko ma ra ya beni. ma ra ya ñ'ete inbi hopi da ju man'aki ra ñ'u nuya ts'okate. pe nuya inbi hoki ra b'ai.
nuua di udihe ra hñäpi bi nto̱t'e bi nja ra agosto ra je̱ya 1595, n'a ra jä'i mra thuhu ra miguel hernández, ra me Chiyauhtzinco,	nuua di udihe ra hñäpi bi nto̱t'e bi nja ra agosto ra je̱ya 1595, n'a ra jä'i mra thuhu ra miguel hernández, ra me Chiyauhtzinco
nuya bo̱nahmu ya mem'onda ñätsi bi ñäui ra Cihuacóatl Tlacotzin m'estho bi thädi:	nuya bo̱nahmu ya mem'onda ñätsi bi ñäui ra Cihuacóatl Tlacotzin m'estho bi thädi
ra Tlacatécatl mra me Cuauhtitlan ne ra bktri ra mbot'a ngu bri japi ya tsat'yo bi zi.	ra Tlakatékatl mra me Kwahtitlan ne ra bktri ra mbota ngu bri japi ya tsat'yo bi zi.
ra doy'e̱ pahni xki njom'i ko ya chalchihuite.	ra doy'e pahni xki njomi ko ya chalchihuite
ra mu̱di ra Cuauhtémoc, ra hmu ra bondo, ra nyoho ra Tlacotzin, ra Cihuacóatl ra nhñu ra oquiztzin, ra bo̱nahmu ha ra nini ra Azcapotzalco Mexicapan, ra ngoho ra panitzin, ra bo̱nahmu nuni ra Ecatepec,	ra mũdi ra Cuauhtémoc, ra hmu ra bondo, ra ñoho ra Tlacotzin, ra Cihuacóatl ra ñu ra oquiztzin, ra bõnahmu ha ra nini ra Azcapotzalco Mexicapan, ra ngoho ra panitzin, ra bõnahmu nuni ra Ecatepec
ra mu̱di ra pa mi o̱t'e ra ngo ra mäkime ra u, ra thuhu ra Huixtocihuatl	ra mu̱di ra pa mi o̱t'e ra ngo ra mákime ra u, ra t'uhu ra Huixtocihuatl
ra nge'a bi mu̱ni ko ra mahuai ha ra xu̱tha nu'a to'o bi umbabi ra ji.	ra ngi'a bi mu̱ni ko ra mahwai ha ra xu̱ta nu'a to'o bi umbabi ra ji.
ra nyoho, bi tho ra ndä ra Nauhtla, mra thuhu ra Cohualpopocatzin.	ra ñoho, bi tho ra ndä ra Nawhtla, mra thu'u ra Kowalpopokatsin.
unga ya ngue̱nda te ra ts'omu̱i mi bu̱'i ne mi japi da ntso̱m'i nuya macehualtin, njabu̱ mi thutuabi ya jä'i mi b'u̱i te ma za	unga ya ngwe̱nda te ra tso̱mu̱i mi bu̱'i ne mi japi da ntso̱m'i nuya macehualtin, njabu̱ mi thutuabi ya jä'i mi b'u̱i te ma za
xib'u̱ bri fádi ge nuya he mi ja nuni ra Cuauhchichilco, ha Xaltocan; ge mi pttsi ya ndá.	OTS: xibu bri fadi ge nuya he mi ja nuni ra Cuauhchichilco, ha Xaltocan; ge mi pttsi ya nda.
xki mbo̱ni nubu̱ ra hyodi ra Cuehuecatitlan,	xki mboni nubü ra hyodi ra Cuehuecatitlan
xki thete ra ixtlilxóchitl ne ra ku ra Cohuanacotzin ko ya he dega dänga ndä bi mu̱di da häni ra hoga ts'ofo ya evangelio,	xki thete ra ixtlilxóchitl ne ra ku ra Cohuanacotzin ko ya he dega dänga ndä bi mu̱di da häni ra hoga ts'ofo ya evangelio
ya dänga ñu̱ni nsafi, ya nsafi, ya mahuai, hangu nu'u̱ gatho xki tagi mbo ha ra hñe.	ya dangá ñuni nsáfi, ya nsáfi, ya máhuai, hangu nu'u gátho xki tági mbo ha ra hñe.
bi o̱tuabi nu'a ra makja xki nk'ohni mra thuhu ra alonso ruiz, ge mi y'o nuni huamuxtitan (Huamuxtitlan) nuni ra hyodi guerrero.	bi o̱tuabi nu'a ra makya xki nk'ohi mra tuhu ra alonso ruiz, ge mi y'o nuni huamuxtitan (Huamuxtitlan) nuni ra hyodi guerrero
di pädi xahño nuna b'e̱fi nehe yoho to'o di pädi da mpe̱fi da y'este nuya hoga do mahye̱gi ya xito, mra thuhu ra ambetz'ihuay.	di pädi xahño nuna b'efi nehe yoho to'o di pädi da mpefi da y'este nuya hoga do mahyegi ya xito, mra thuhu ra ambetz'ihuay
dra thoki ra nto̱de, ra ketzal dra b'e̱ nuni Coyohuacan.	dra thoki ra ndo̱de, ra ketsal dra b'e̱ nuni Coyohuacan
e mi r'ani dega xui ra Cihuacóatl g'ea mi zoni ne mı mafi.	e mi r'ani dega xui ra Cihuacóatl g'ea mi zoni ne mı mafi
ebu̱ bi gäi habu̱ mi to̱ge ebu̱ bi yopa ma ha ra hnini ra Cuetaxtlan,	ebu bi gäi habu mi toge ebu bi yopa ma ha ra hnini ra Kuetaxtlan
ge'a ra mu̱di ra thuhu ra Hernando, ra nge'a njabu̱ mra thuhu ra takjä ra Cortés nehe njabu̱ mra thuhu ra ndä católico ne ra ku ra Cohuanacotzin bi thutuabi ra pedro po ra Pedro Alvarado ra nge'a ra takjä,	ge'a ra mu̱di ra t'u̱hu ra Hernando, ra nge'a njabu̱ mra t'u̱hu ra tajä ra Cortés nehe njabu̱ mra t'u̱hu ra ndä católico ne ra ku ra Cohuanacotzin bi t'u̱t'abi ra pedro po ra Pedro Alvarado ra nge'a ra tajä
ma n'a mi b'ai nuni teotletso, habu̱ ra ñ'u̱ pa manjuäntho pa da zo̱ni nuni ra peñón (Tepetzinco).	ma n'a mi b'ai nuni teotlezo, habu ra ñ'u pa manjuanto pa da zoni nuni ra peñón
"mi tso̱ho̱ getbu̱ ra fu̱nga t'o̱ho̱, habu̱ mi thutuabi ""tajón ra nxu̱ni, njabu̱ bi hutuabi ya ndeznä ya b'e̱hnanoya bi pe̱hni ra ts'e̱y'e̱hmu, mi gu̱t'a ra ñ'u ra Tzihuacpopocatzin, bi bo̱nga ha ra ñ'u."	"mi tso̱ho̱ getbu̱ ra fu̱nga t'o̱ho̱, habu̱ mi thutuabi ""tajón ra nxu̱ni, njabu̱ bi hutuabi ya ndeznä ya b'e̱hnanoya bi pe̱hni ra ts'e̱y'e̱hmu, mi gu̱t'a ra ñ'u ra Tzihuacpopocatzin, bi bo̱nga ha ra ñ'u"
mra ku ra Cacamatzin mra bo̱nahmu nuni Tetzcoco mri ñ'oui va jä'i mi y'o mpaha.	mra ku ra Cacamatzin mra bo̱nahmu nuni Tetzcoco mri ñ'oi va jä'i mi y'o mpaha.
n'a ra nto̱de dega chalchihuite, xi m'et'e dega ze̱ka do, nehe mi pe̱tsi n'a ra tsant'i de ga k'astaboja.	n'a ra ntode dega chalchihuite, xi m'ete dega zeka do, nehe mi petsi n'a ra tsanti de ga k'astaboja
ne ndunthi ya ambetz'ihuay ne mar'a hoga do mi pe̱tsi ra mu'ui:	ne ndunthi ya ambetz'ihuay ne mar'a hoga do mi pe̱tsi ra mu'ui
nehe n'a ya the̱sthi dega mboťahuaido.	nehe n'a ya thesti dega mbodahuaido.
nuna bi o̱t'a ra ntso̱m'i ra nge'a nehe nuya ya b'e̱datsi bi tsini ko ra Cortés ne ra Cohuanacotzin ne ra ixtlilxóchitl xki nsofo pa ra ixtlilxóchitl da gu̱ka ya jä'i ge mi zu ya hyodi, njabu̱ mi pe̱hna ajuä da t'o̱t'e.	nuna bi o̱t'a ra ntso̱m'i ra nge'a nehe nuya ya b'e̱datsi bi tsini ko ra Cortés ne ra Cohuanacotzin ne ra ixtlilxóchitl xki nsofo pa ra ixtlilxóchitl da gu̱ka ya jä'i ge mi zu ya hyodi, njabu̱ mi pe̱hna ajuä da t'o̱t'e
nuna nt'o̱t'e bi nthandi xa nts'ogi njabu̱ bri thutuabi, bi ena ge mra nzu̱te ko ma m'u̱hai ra nzu̱te ne mi thutsuabi ko ya mpe̱bi dega mabagì, habu̱ hmä ge n'a di ge'u̱ bi y'e̱nga n'a ra do, ko nge'a bi hyo, nu'u̱ mar'a ya b'e̱go ge mä ge nu'u̱ se̱he̱ ya ñämfo̱ bi hyo bi mu̱tu'a n'a ra mahuai ha ri ngati bi mu̱tuabi n'a ra nzu̱ni.	nuna nt'ot'e bi nthandi xa nts'ogi njabu bri thutuabi, bi ena ge mra nzu̱te ko ma m'u̱hai ra nzu̱te ne mi thutsuabi ko ya mpe̱bi dega mabagi, habu̱ hma ge n'a di ge'u̱ bi ye̱nga n'a ra do, ko nge'a bi hyo, nu'u̱ mar'a ya be̱go ge ma ge nu'u̱ se̱he̱ ya ñamfo̱ bi hyo bi mutu'a n'a ra mahuai ha ri ngati bi mutuabi n'a ra nzuni.
ra Cuauhtémoc, Tlacotzin, ra Cihuacóatl, Oquiztzin, Panitzin, Motelhuihtzin; nuna bi sofo ra Cortés nuni Coyoacan, nu'u̱ to'o mi pädi yoho ya hñäki ngu'a ra jerónimo aguilar ra malintzin.	ra Cuauhtémoc, Tlacotzin, ra Cihuacóatl, Oquiztzin, Panitzin, Motelhuihtzin; nuna bi sofo ra Cortés nuni Coyoacan, nu'u̱ to'o mi pädi yoho ya hñäki ngu'a ra jerónimo aguilar ra malintzin
t'ena ge ya macehual [ya jä'i b'u̱i ha ra hyoya]	t'ena ge ya macehual [ya jä'i b'ui ha ra hyoya]
"xki thokuabi nuya hotho ts'ints'u̱ mra thuhu ra ""tlauhquecho"" ne “tzinitzcan zacuan"","	"xki thokwa̱bi nuya hotho ts'ints'u̱ mra thuhu ra ""tlauhquecho"" ne “tzinitzcan zacuan”"
-¿te be'a gi mä nu'i Cihuacóatl?	-¿te pe'a gi mä nu'i Cihuacóatl?
bi k'ahni ko ya dänga ñuni nzafi ne bi thetse ko ya makahuai nuya otomi geb'u̱ bi japi bi b'e̱di, bi mä nuyu̱:	OTS: bi k'ahni ko ya dangga ñuni nzafi ne bi thetse ko ya makahuai nuya otomi geb'u bi japi bi b'edi, bi ma nuyu
da thuts'i ya njot'ihñä ( )	da tuts'i ya njot'ihñä
da umbabihe te da zi, da japabihe ndunthi ma zu.	da umbabihe te da zi, da japabihe ndunthi ma zu
ebu̱ bi mä nuna b'e̱fi xa thoki xahño bi johya ra ts'e̱y'e̱hmu.	ebu bi ma nuna befi xa thoki xahño bi johya ra tsehmu
"fernando alva ixtlilxóchitl, xiii njändahmä ""ra ñ'ehe ya ñämfo̱ ne ra mu̱di ra hoga ts'ofo ra evangelio."""	"OTS: fernando alva ixtlilxóchitl, xiii njändahmä ""ra ñ'ehe ya ñämfo ne ra mu̱di ra hoga ts'ofo ra evangelio."""
ga juatihu̱ nu'a huts'i njani, ya ts'ojä'i, ra carranza, ge xa o̱t'a ya ts'okuate pa gekagihu̱; ga o̱t'e da nja ra ts'e̱di ma munts' ne njabu̱ ga tsu̱dihu̱ da nja nu'a ra hoga tsu̱tui, da nja ra hai, ra hñegi ne ra hoga ts'u̱tui;	ga juatihu nu'a huts'i njani, ya ts'ojä'i, ra carranza, ge xa o̱t'a ya ts'okuate pa gekagihu; ga o̱t'e da nja ra ts'e̱di ma munts' ne njabu ga tsu̱dihu da nja nu'a ra hoga tsu̱tui, da nja ra hai, ra hñegi ne ra hoga ts'u̱tui
gatho ya hyoyajä'i mi b'u̱i ha ra hnini bi handi.	gatho ya hyoyajä'i mi b'ui ha ra hnini bi handi
ha bi häni ra ñ'udi, ma jä'ihu̱ bi ent'i gatho mahye̱gi nuya nzu̱te	ha bi hani ra ñudi, ma jaihu bi enti gatho mahyegi nuya nzute
ha n'aa nza̱tho xudi ra pale berto, bi bo̱ni nda hyonga te nda nzimxidi ngetho nda zi ya hme hyaxtho mi u̱xa ya u, ua ngu mi nzäi mi nkahui yá hme nuya chuju̱ xa hogi ha nuya 'bomuha̱i nts'ät'i, nt'o̱kuä;	ha naa nzatho xudi ra pale berto, bi boni nda hyonga te nda nzimxidi ngetho nda zi ya hme hyaxtho mi uxa ya u, ua ngu mi nza̱i mi nkahui ya hme nuya chuju̱ xa hogi ha nuya 'bomuha̱i nts'ät'i, nt'o̱kuä
ha nubia di ndäki, di ndändiñähmu, di ma ga ts'u̱tsa'i ri y'e, ga ndäne'i ra nge'a nu'a'i ma makjahe, ra bartolomé lópez, nub'u̱ mi njuäni ma b'e̱hña inbi njuäni ha nubu̱ mi xaxi pa da o̱t'a ya tso̱mfen	ha nubia di ndäki, di ndändiñähmu, di ma ga ts'u̱tsa'i ri y'e, ga ndäne'i ra nge'a nu'a'i ma makjahe, ra bartolomé lópez, nub'u̱ mi njuäni ma b'e̱hña inbi njuäni ha nubu̱ mi xaxi pa da o̱t'a ya tso̱mfen
ha ya t'u̱ka ze̱ki thuts'i n'a tu̱kitho nuna thogi ge bi huxa ra fernando alva ixtlilxóchitl, nu'a b'e̱tsi ra xiiii njondahmä.	ha ya t'uka zeki thuts'i n'a tukitho nuna thogi ge bi huxa ra fernando alva ixtlilxóchitl, nu'a bets'i ra xiiii njondahmä.
habu̱ ga ju̱he nuyu̱ (ya tenochcas) te gi honihu̱?	habu ga juhe nuyu (ya tenochcas) te gi honihu
ham'u̱ gatho ya juän'ahmä ge nuua xa ze̱ti ri ñ'ehe dige'a ya noya ya mu̱dimehai ha ra hñä ya ndeznä, nuna thuhu ri uni inga se̱he̱ ra n'atsanoya pa da fädi ra hñämfo̱, ingi ri me̱udi dige'a ra hmä fu̱oti dige'a nuna ra hñäki ra netzahualcoyotl. ne ra cuauhtémoc.	ham'u gatho ya juän'ahmä ge nuua xa zeti ri ñ'ehe dige'a ya noya ya mudimehai ha ra hñä ya ndeznä, nuna thuhu ri uni inga sehe ra n'atsanoya pa da fädi ra hñämfo, ingi ri meudi dige'a ra hmä fuoti dige'a nuna ra hñäki ra netzahualcoyotl. ne ra cuauhtémoc.
mi hneki ngu ma jä'ihu̱ ngabu̱ mri hneki.	mi hneki ngu ma jahi ngabu mri hneki
ndunthi bri johya, bri thuxpabi gatho nu'a mi o̱t'abi ra b'edi, ko nge'u̱ bi m'u̱i ne mi t'umbabi ya t'ixu:	ndunthi bri johya, bri thuxpabi gatho nu'a mi o̱t'abi ra b'edi, ko nge'u̱ bi m'u̱i ne mi t'umbabi ya t'ixu
ngu mra me̱ti, nu'a r'a hyodi, habu mi y'o, n'a ngu n'a mi johya mi mfe̱m'a xinxi xi mi johya ya ndäte, mi thede n'a ngu n'a mi hñu̱fi ne mi fe̱m'a ya xinxi: xi mi b'u̱i mpaha.	ngu mra me̱ti, nu'a r'a hyodi, habu mi y'o, n'a ngu n'a mi johya mi mfe̱m'a xinxi xi mi johya ya ndäte, mi thede n'a ngu n'a mi hñu̱fi ne mi fe̱m'a ya xinxi: xi mi b'u̱i mpaha
njabu̱ ri ñ'ehe ya je̱ya inda m'e̱di, inda mpumfri, ga nzäi ga pe̱tsi nugagihu̱ ha ma mfenihu̱, ga pe̱tsi nugagihu̱, ra bätsi dige'u̱, ya b'e̱to, ya ntsaniku, ya mbänga b'e̱to ne to'o dra ñ'epu̱, to'o mahye̱gigihu̱, ma jihu̱, ya ku̱hu̱.	njabu ri ñ'ehe ya je̱ya inda m'e̱di, inda mpumfri, ga nzäi ga pe̱tsi nugagihu ha ma mfenihu, ga pe̱tsi nugagihu, ra bätsi dige'u, ya b'e̱to, ya ntsaniku, ya mbänga b'e̱to ne to'o dra ñ'epu, to'o mahye̱gigihu, ma jihu, ya ku̱hu.
nu xä oth'u̱, ma gä ñ'jähu̱	nu xa othu, ma ga njahu
nuga̱ xi di ne'i, hindi pädi hanja...	nuga̱ xi di ne'i, hindi pädi hanja...
num'u̱ di johyahu̱, nkuehu̱, nts'o̱mihu̱, tsuhu ne pa da t'o̱xkähu̱ di hohñu̱ nu ya nt'u̱i xi di 'yoohu̱ (¡!). nuya da nt'ot'i ko ra dänt'ot'í	OTS: num'u di johyahu, nkuehu, nts'omihu, tsuhu ne pa da t'oxkahu di hohñu nu ya nt'ui xi di 'yoohu (¡!). nuya da nt'ot'i ko ra dänt'ot'i
nuna bi johya ha ra mabagi,	nuna bi johya ha ra mabagi
nuya hñu o gohoya pa bi b'u̱i nubu̱ bi xitsuabi ra jäpadehe ndunthi ya jä'i, ngu xa t'ena.	nuya hñu o gohoya pa bi b'ui nubu bi xitsuabi ra jäpadehe ndunthi ya jä'i, ngu xa t'ena
nuya tsat'io mi b'et'o, mi gu̱t'a ra ñ'u, mi teni, ya xiñu mi ju̱ts'i pa mañä, xi mi pähä gatho mi handi mi nest'ihi: mi tu̱ta ya jihni	nuya tsatío mi betó, mi gutá ra ñu, mi teni, ya xiñu mi jutsí pa maña, xi mi pahá gatho mi handi mi nestihi: mi tutá ya jihni
pe, nu'i ndada nu'i ma t'ek'ei ra makja, nub'u̱ nu'i ingi zugagihe, ¿hanja, nuua, ra hyo di ge'a, ga tsogi nubu̱ [nu'a ma b'e̱hña]?	pe, nu'i ndada nu'i ma t'ek'ei ra makya, nub'u nu'i ingi zugagihe, ¿hanja, nuua, ra hyo di ge'a, ga tsogi nub'u [nu'a ma b'ehña]?
r'a ya jä'i mi b'u̱i ha ra ngumi ja nunu ha ra hnini ri manjuäntho pa da tsoni nubu̱ ra amáxac,	r'a ya jä'i mi b'u̱i ha ra ngumi ja nunu ha ra hnini ri manjuäntho pa da tsoni nubu̱ ra amáxac
ra nge'a di o̱t'a nuna noya ra ts'u̱tui ne gatho to'o da guat'a ha ma hyohe, nu'u̱ to'o da ne, da me̱tsi n'a ra hoga m'u̱i ne da m'u̱i manjuänthä. ha nubu̱ xa mabu̱ ma noya ge di pe̱tsi ra tsa, dega hoga jä'i ne dega hogat'o̱t'antuhni	ra ngä'a di o̱t'a nuna noya ra ts'ütüi ne gatho to'o da guat'a ha ma hyohe, nu'u̱ to'o da ne, da me̱tsi n'a ra hoga m'ütüi ne da m'ütüi manjuänthä. ha nubü̱ xa mabü̱ ma noya ge di pe̱tsi ra tsa, dega hoga jä'i ne dega hogat'o̱t'antuhni
ra ngehna nuna pa bi ma n'a ra ñ'u manjuäntho.	ra ngexna nuna pa bi ma n'a ra ñ'u manjuäntho
ra nhñu ne ra ngästsi ra b'ist'ofo di huts'ihu̱ ha nuna ze̱ki b'ist'ofo, ri ñ'ehe ra vii njondahmä ra chimalpain,	ra nhñu ne ra ngätsi ra b'ist'ofo di huts'ihu ha nuna zeki b'ist'ofo, ri ñ'ehe ra vii njondahmä ra chimapain
ra nthädi ra cuitlahuacatzin bi ena ge ina da o̱t'e nuya bi b'e̱pabi ya nso̱ho̱jä'i,	ra ndädi ra kuitlahuakatzin bi ena ge ina da o̱t'e nuya bi b'epabi ya nso̱ho̱jä'i
ra nyoho nu'a mi zu ra tepoztlan; ra nhñu ra me tizatlan, ra njoho mi ñ'ehe nuni huehuetlan ne ra nku̱ta mra dänga mictlan.	ra ñoño nu'a mi zu ra tepoztlan; ra ñhñu ra me tizatlan, ra ñoño mi ñ'ehe nuni huehuetlan ne ra nku̱ta mra dänga mictlan
ri ñ'udi xahño nubia hanja beni ya metlaxcala bi do̱m'i mpaha nuya nso̱ho̱ jä'i.	ri ñ'udi xahño nubia hanja beni ya Metlaxcala bi do̱m'i mpaha nuya nso̱ho̱ jä'i.
t'ena ge inbi unga mfädi pa gatho ya jä'i mi ñ'oui, ge nuna ndada ra marqués da ñ'ehe dra hmu ha ma haihe, da ja me̱ti nu'a di pe̱tsihe nehe dra jakagihe ga mpe̱fihe ra hai ge bi umbabi o bi hänbabi ya hoga hai ya n'añ'o hnini.	t'ena ge inbi unga mfädi pa gatho ya jä'i mi ñ'oui, ge nuna ndada ra markés da ñ'ehe dra hmu ha ma haihe, da ja me̱ti nu'a di pe̱tsihe nehe dra jakagihe ga mpe̱fihe ra hai ge bi umbabi o bi hänbabi ya hoga hai ya n'añ'o hnini.
xi mi taxki ra ñ'u, imbi tsa da r'anga n'a, ho̱nse̱he̱ mi taxka n'a ha ra bo̱hai. ya y'ofadi mi ju̱t'atho.	OTS: xi mi taxki ra ñ'u, imbi tsa da r'anga n'a, honshehe mi taxka n'a ha ra bohai. ya y'ofadi mi jut'atho.
ya dänga mfu̱nga bo̱jä bi ntho, bi kot'i ko ya mahjuai, mi zu̱m'i nehe ko ya t'e̱nga ts'u̱t'abo̱ja.	ya dangá mfúngá bojä bi ntho, bi kot'i ko ya majwai, mi zum'i nehe ko ya t'engá ts'ut'abojä.
ya r'atsanoya ra sahagún mi mä hanja mi yopa tsini. ya ndeznä bi nkohi inda ñ'udi. mi hatatho pa bi mu̱di ra ntuhni	ya r'atsanoya ra sahagún mi mä hanja mi yopa tsini. ya ndeznä bi nkohi inda ñ'udi. mi hatatho pa bi mu̱di ra ntuhni
ya zi b'e̱hña mi ägi ha ya b'a ne ha ya ngo̱de, nuya ñ'o̱ho̱ mbo ha ya ne, ha ya njom'ahudi.	ya zi b'ehña mi ägi ha ya b'a ne ha ya ngode, nuya ñ'oho mbo ha ya ne, ha ya njom'ahudi
bi boxro xi 'be̱ts'ina, bido'u̱ ro 'yu̱ni 'na, xi bi bo̱x ro hjua 'na, bido'u̱ ro ts'ii 'na, xi bo̱xro ts'äre 'na. ge'bu̱ go min pu̱n doja 'na.	bi boxro xi bets'ina, bido'u ro yuni na, xi bi box ro hua na, bido'u ro ts'ii na, xi boxro ts'äre na. gebu go min pun doja na.
bi ma manjuäntho habu̱ mi b'u̱i ra ts'e̱y'e̱hmu bi xipabi;	bi ma manjuantho habu mi b'ui ra tse'ehmu bi xipabi
bri juahni po nuya dra hmu.	bri juahni po nuya dra hmú
di to̱m'ihe ra ñ'ethi pa nugagihe, n'a ra pa ngu ma n'a ra pa thogi nekagihe di huadihe ra nge'a indi tse̱tihe nuna b'u̱i t'o̱t'e ko ngekagihe man'año ya ntho, t'e̱nts'igihe thi ma haihe ma me̱tihe, ju̱kagihe ga mpe̱fihe ndunthi, b'e̱kagihe ga jut'ihe xdunthi ya boja, n'a ngu n'a ra pa nuna njut'i di o̱t'ehe man'a te ma thaihe di tuhe.	di tom'ih ra ñ'ethi pa nugagih, n'a ra pa ngu ma n'a ra pa thogih nekagih di huadih ra ng'a indi tsetih nuna b'ui t'ot'e ko ng'ekagih man'anyo ya ntho, t'ents'igih thi ma haih ma metih, jukagih ga mpefih ndunthi, b'ekagih ga jut'ih x'dunthi ya boja, n'a ngu n'a ra pa nuna njut'i di o't'eh man'a te ma thaih di tuh.
gatho nuna hai ha nuna r'ayo ximhai njabu̱ bi thutuabi nuya nso̱ho̱jä'i inbi tsa bi thutuabi man'a ra thuhu.	gatho nuna hai ha nuna r'ayo ximhai njabu bi thutuabi nuya nso̱ho̱jä'i inbi tsa bi thutuabi man'a ra thuhu
ha mi tso nde, bi mu̱di bi nja n'a ra hneki ngu njagihu̱ dega jä'i, bi t'ot'e ra b'ai ngu dega jä'i,	ha mi tso nde, bi mu̱di bi nja n'a ra hneki ngu njagihu̱ dega jä'i, bi t'ot'e ra b'ai ngu dega jä'i
ma bo̱nahmu'ihe: nuna b'e̱fi ga tsokagihe sta juatihe gatho: gi nuti nuua, xa hño bo̱nahmu.	ma bōnahmu'ihe: nuna b'ēfi ga tsōkagihe sta juatihe gathō: gi nuti nuua, xa hño bōnahmu.
mi mä dega ts'e̱dira hñä tso̱pu da ts'o̱ho̱bu nuya nzo̱ho̱jä'i ga handihu̱ te ma ts'e̱di pe̱tsi, ra nge'a ma ajuä ra quetzalcohuatl b'u̱i nuua ko ngekagihu̱,	mi má de ga ts'edirá ñä tso'pu da ts'oho'bu nuya ñzo'ho'jä'i ga handihu te ma ts'edi pe'tsi, ra nge'a ma ajua ra quetzalcohuatl b'u'i nuua ko ngekagihu
ne ya nt'u̱i, hanja di thuts'i ya nt'ofo, njap'u̱ nehe mä 'ra ya mpeu̱i da fats'i di nt'ot'i ra hñähñu	ne ya nt'üi, hanja di tuts'i ya nt'ofö, njap'ü nehe mä 'ra ya mpeüi da fats'i di nt'ot'i ra hñähñu
nub'u̱ nu'i ingi japi da bo̱nga nu'a ra makja ha nu'a ra hnini, ¿hanja ra yotui, ga tso̱gi nubu̱ ma b'e̱hña? o̱t'a r'ato ya je̱ya bi mu̱di [ra makja ra bartolomé lópez]	nub'u nu'i ingi japi da bo̱nga nu'a ra makja ha nu'a ra hnini, ¿hanja ra yotui, ga tso̱gi nubu ma b'e̱hña? o̱t'a r'ato ya je̱ya bi mu̱di [ra makja ra bartolomé lópez]
pa ga b'u̱i mpaha ne ga o̱t'e n'a ra njondahmä gatho nu'a ga handi.	pa ga b'ui mpaha ne ga ote n'a ra njondahmä gatho nu'a ga handi
r'a nuna mi nthandi ngu nu'a ma thänjuahu̱ (ychtlilmatli), xi mra nts'o, mi kuet'e ha ya ngo̱,	r'a nuna mi nthandi ngu nu'a ma thänjuahu (ychtlilmatli), xi mra nts'o, mi kuet'e ha ya ngo
xa zägi mpaha, nub'u̱ xa njabu̱ xa japabi ma zu ne inte xa t'o̱tuabi nub'u̱ inda japi xa po̱ho̱ bi ya kue̱ ra nge'a ya jä'i xi mra no̱t'e ne mra hyotejä'i,	xa zägi mpaha, nub'u xa njabu xa japabi ma zu ne inte xa t'otabi nub'u inda japi xa poxo bi ya kue ra nge'a ya jä'i xi mra no't'e ne mra hyotejä'i
y'o, ri ma ne gi xipabihu̱ ya metlaxcala ge ma r'a ya me̱ti jä'i ne ri ajuähu̱, ge nu'a ga mä ge xa ehe nuua ma haihu̱, ge di umbabihe ma nthädihe.	y'o, ri ma ne gi xipabihu ya metlaxcala ge ma r'a ya me̱ti jä'i ne ri ajuähu, ge nu'a ga mä ge xa ehe nuua ma haihu, ge di umbabihe ma nthädihe
¿te da o̱t'e ma jä'ihu̱ sta b'e̱dihu̱?	¿te da o̱t'e ma jä'ihu̱ sta b'edihu̱
-da ts'iua:... ri ñ'ehe ge'a ma njueih'u̱. da o̱t'ehe ya ñ'o̱te ko ya he̱m'i, ya ñ'o̱t'ehe ko ya ntuts'i. da o̱ts'e̱ ra b'e̱na noya.	-da ts'iua:... ri ñ'ehe ge'a ma njueih'u̱. da o̱t'ehe ya ñ'o̱te ko ya hem'i, ya ñ'o̱t'ehe ko ya ntuts'i. da o̱ts'e̱ ra b'e̱na noya.
-dom'i ma ajuähu̱ ge inda yu̱t'a ha ma nguhu̱ nuhu̱ to'o e̱nts'i pa thi ne da hokuabi ra honanhyo nub'u̱ sta ne da hyoki ya inda za.	-ndom'i ma axuahu ge inda yut'a ha ma nguhu nuhu to'o ents'i pa thi ne da hokabi ra honanyo nub'u sta ne da hyoki ya inda za.
-o̱t'a ra mäte gi o̱dehu̱, ja gi b'ai nuuahu̱. mont'a ya ngo ajuä; ri juat'i ra ngo ga tsunda ma ajuähe.	-ot'a ra mate gi odehu, ja gi b'ai nuahu. mont'a ya ngo ajuä; ri juat'i ra ngo ga tsunda ma ajuähe
-xa hño, di b'u̱ihe njamädihe.	-ja hño, di b'üihe njamädihe.
-¿nguande njabu̱ ga mäu gra juähu̱?	-¿nguande njabu ga mäu gra juähu
-ñ'emabagi, ya gabida, ya jä'ihu̱ gi pädi ra ntuni ra mem'onda ba ehehu̱ ga te̱nihu̱ma nzu̱tehu̱. ko ya mätsa mi te̱he̱, ko ya bu̱'bai ko ngatho ra ts'e̱di mi te̱he̱ ra ñ'u.	-ñ'emabagi, ya gabida, ya jä'ihu gi pädi ra ntuni ra mem'onda ba ehehu ga te̱nihu̱ma nzu̱tehu̱. ko ya mätsa mi te̱he, ko ya bu̱'bai ko ngatho ra ts'e̱di mi te̱he ra ñ'u.
bi tse̱ti nuna ngot'i ra m'onda, ngu pede ra dänga b'ede, ya k'oi ne ya njändahmä, ngu nu'a ra hmä ra alonso axayaca, goho n'ate ma pa bi nzo̱t'e nuna pa.	bi tseti nuna ngoti ra mondo, ngu pede ra dangabe, ya k'oi ne ya njendahma, ngu nu'a ra hma ra alonso axayaca, goho n'ate ma pa bizot'e nuna pa.
into y'o manjuäntho, into pa ri nektho.	into y'o manjuäntho, into pa ri nektho
nub'u̱ ndi umbabihe ma njut'ihe xki nzäi ndi da'ihe, mi adi n'a tu̱ki nehe nub'u̱ ndi unihe ya k'astaboja mi häni made n'a tu̱ki [...]	nub'u ndi umbabihe ma njut'ihe xki nzäi ndi da'ihe, mi adi n'a tu̱ki nehe nub'u ndi unihe ya k'astaboja mi häni made n'a tu̱ki
ya miñ'o ko ngehna hmä ri johya,	ya miño ko ngeña hmä ri johya
bi tso̱hso̱ ra ngo ma ajuähu̱: nubia da fu̱di da guadi ra r'e̱t'a ra pa.	OTS: bi tso̱hso̱ ra ngo ma ajua̱hu̱: nubia da fu̱di da guadi ra r'e̱t'a ra pa.
