OTS	OTQ
"-pasadores: ""ya nts'äza xi mra nts'u̱t'i mi t'e̱ni ko n'a ra t'e̱nga ts'u̱t'a bo̱kja mi tjutuabi ra ballesta""."	"-pasadores: ""ya nts'äza xi mra nts'u̱t'i mi t'e̱ni ko n'a ra t'e̱nga ts'u̱t'a bo̱kja mi tjutuabi ra ballesta""."
cantares mexicanos, biblioteca nacional de méxico, ya nt'ofo 1628 bis, folio 16 v.	cantares mexicanos, biblioteca nacional de méxico, ya nd'ofo 1628 bis, folio 16 b.
"ebu̱ bi bo̱ni, bi meui nuni nonohualco, ja ra ngu ra b'ongui jabu̱ ra gabida ne ra malintzin ne ""ra jyadi"" (alvarado) ne ra sandoval."	"ebu bi boni, bi meui nuni nonohualco, ja ra ngu ra b'ongui jabu ra gabida ne ra malintzin ne ""ra jyadi"" (Alvarado) ne ra Sandoval."
gi jandi ra nt'ofo ra tjuju ra crónicas de la conquista	gi handi ra nd'ofo ra t'u'u ra crónicas de la conquista
guzmán. ja ya je̱m'i b'e̱tsa kje̱ya manteb'u̱ di ge nuua m'onda ne ya jyo, nu'a ra jmä ra 12-conejo (1530) ge xa jmä ge xibú bi yut'i ja ra culhuacan ya ndeznä, nda pablo xochiquetzin, motelchiuhtzin ne ra guzman.	gusmán. ha ya hem'i b'etsa khey'a manteb'u di ge nuwa m'onda ne ya jyo, nu'a ra jmä ra 12-conejo (1530) ge kha jmä ge xibú bi yut'i ha ra kulwakan ya ndeznä, nda pablo sochiketsin, motelchiwhtsin ne ra gusmán.
ja ga ñ'udiju̱ ra nt'ofo ya ñämfo̱ po ra ntjuts'i ra doctor garibay,	ja ga ñ'udiju̱ ra nd'ofo ya ñämfö̱ po ra ndjuc'i ra doctor garibay,
ja nu'a jyodi nubia tjutuabi ra san martin.	ja nu'a jyodi nubia tjutuabi ra san martín.
je̱mi unga mfädi ja ra t'u̱ka jnini jabu̱ b'u̱i ya kjä'i teni ra división ra arenas, 27 ra abril ra kje̱ya 1918, ra m'ets'a je̱m'i ra zapata, b'e̱tsi ja ra universidad nacional autónoma de méxico, expediente 29.	je̱mi unga mfädi ja ra t'u̱ka jnini jabu̱ b'u̱i ya kjä'i teni ra división ra arenas, 27 ra abril ra kje̱ya 1918, ra m'ets'a je̱m'i ra zapata, b'e̱tsi ja ra universidad nacional autónoma de méxico, expediente 29.
"m'e̱fa ja ra jñuti bri tjätuabi na ra jñe xki tagiri mo̱te, neje bri kjom'a ra xu̱tja ko n'a ra t'axa dutu mra tjujuu ra ""campanillante""."	"m'efa ja ra jñuti bri tjätuabi na ra jñe xki tagiri mo̱te, neje bri kjom'a ra xu̱tja ko n'a ra t'axa dutu mra tjujuu ra ""campanillante""."
ma dada'ije gra ts'u̱tui, di ne gi pädi ge ma me̱t'o instä tjogije nuna tjogi gatjo ya mapa xki r'ani, bi kjuat'i ko ngeke nu̱'u ri b'e̱go, ri me̱fi ya ñämfo̱, ra nge'a makjuäni ra hernando cortés ra ndä gabida,	ma dada'ije gra ts'u̱tui, di ne gi pädi ge ma me̱t'o instä tjogije nuna tjogi gatjo ya mapa xki r'ani, bi kjuat'i ko ngeke nu̱'u ri b'e̱go, ri me̱fi ya ñämfo̱, ra nge'a makjuäni ra hernando cortés ra ndä gabida,
mi b'u̱i ya mu̱dimejai mi ñä ra ndeznä ne jabu̱ ra jnini dige'a gatjo ra nxiki m'onda ngu r'a ya yaqui b'u̱i nuni sonora ne ya maya ri ñ'eje nuni yucatán ra nge bi guat'i ja ra tujni bi nkja nuua m'onda fädi ko ra tjuju ra revolución mexicana ya kje̱ya 1910-1919.	mi b'u̱i ya mu̱dimexai mi ñä ra ndeznä ne jabu̱ ra jnini dige'a gatjo ra nxiki m'onda ngu r'a ya yaqui b'u̱i nuni sonora ne ya maya ri ñ'eje nuni yucatán ra nge bi guat'i ja ra tujni bi nkja nuua m'onda fädi ko ra tjuju ra revolución mexicana ya kje̱ya 1910-1919.
mi fo̱tuabi ya ts'u̱tnibo̱kja mi tjutuabi ya jñämfo̱ ra pasadores neje ya bo̱zna ko ya nzafi.	mi fotuabi ya ts'utnibokha mi jutuabi ya ñämfu ra pasadores neje ya bozna ko ya nzafi.
n'a nt'udi di ge'a nuya ntjoki bri t'o̱t'e ja ya jñä ya ndeznä ra ngätsi ra ntjebe nkje̱ya ra r'e̱t'a ma gu̱to (s. xix), r'a ya jnini ngu ra xicontepec (villa juárez) nuna jyodi koji nuni puebla.	n'a nt'udi di ge'a nuya ntjoki bri t'o̱t'e ja ya jñä ya ndeznä ra ngätsi ra ntjebe nkje̱ya ra r'e̱t'a ma gu̱to (s. xix), r'a ya jnini ngu ra xicontepec (villa juárez) nuna jyodi koji nuni puebla.
"n'a ra t'axa dutu mi pe̱tsi ya k'oi ra ixki, nuna mra tjuju jñämfo̱ ""campaneante resonador""."	"n'a ra t'axa dutu mi petsi ya k'oi ra ixki, nuna mra tjuju jñämfo ""campaneante resonador""."
ne ri mpe̱fi ja ra dängan gu nt'udi ra tjuju ra facultad de estudios superiores, acatlán, unam,	ne ri mpefi ja ra dängan gu nt'udi ra tjuju ra facultad de estudios superiores, acatlán, unam,
ntjandi gatjo nu'a ra munts'i ra tjuju jñämfo̱ ra globalización ge 'a po̱ts'e dega nest'iji, nuna y'o̱te to̱m'i da nkja ra ntjo̱mäte.	ntjandi gatjo nu'a ra munts'i ra tjuju jñämfo̱ ra globalización ge 'a po̱ts'e dega nest'iji, nuna y'o̱te to̱m'i da nkja ra ntjo̱mäte.
nu'a ma r'a ya kjä'i mi pädi nuña b'e̱fi bri b'e̱pabi xa jyoki yojo ya mpe̱fi mi fädi ko ra tjuju ra amosqueador ko ya xi ya ts'ints'u̱ xi sta jotjo, gi jutsuabi made dige'a n'a ra zänä dega k'astabokja	nu'a ma r'a ya kjä'i mi pädi nuña b'e̱fi bri b'e̱pabi xa jyoki yojo ya mpe̱fi mi fädi ko ra tjuju ra amosqueador ko ya xi ya ts'ints'u̱ xi sta jotjo, gi jutsuabi made dige'a n'a ra zänä dega k'astabokja
"nu'a ra munts'a kjä'i bi te̱ni bi zipabi man'a ya b'ede, mi t'ena ge ya kjä'i xki b'u̱i nubu̱ inbi pe̱tsi ra ts'e̱di nu'a mi mä pe m'e̱fa bi kjapi bi nxaxni ya tsu̱tui ne n'a ra diputado mi pe̱tsi ra mfeni xki kot'i mra tjuju ra josé maría lozano, bi y'onga ra jmä pa mar'a ya ñ'oui bi nxanxi: ""ri mo̱te ra tjits'i mi udi ra emiliano zapata, neje bri fädi ngu ra atila nuna bri nkju̱tsi [...] nu'a bi fädi ngu mi je̱gi ya b'e̱go ne'a bi mä da uni da nkja pa gatjo, ingi kjot'i [...]"	"nu'a ra munts'a kja'i vi te̱ni vi sipabi man'a ya b'ede, mi t'ena ge ya kja'i xki bu̱i nubu̱ inbi pe̱tsi ra tse̱di nu'a mi mä pe m'e̱fa vi kjapi vi nxaxni ya tsu̱tui ne n'a ra diputado mi pe̱tsi ra mfeni xki kot'i mra tjuju ra josé maría lozano, vi y'onga ra jmä pa mar'a ya ñ'oui vi nxanxi: ""ri mo̱te ra tjits'i mi udi ra emiliano zapata, neje bri fädi ngu ra atila nuna bri nkju̱tsi [...] nu'a vi fädi ngu mi je̱gi ya be̱go ne'a vi mä da uni da nkja pa gatjo, ingi kjot'i [...]"
nu'u̱ to'o ñä ra ndenzä ja r'e̱t'a ma r'at'o ya estados.	nu'u to'o ñä ra ndenzä ja r'e̱t'a ma r'at'o ya estados.
nub'u̱ ri m'e̱jni ne ri b'e̱go ya ñämfo̱ bi kjuat'i ko ngekagije ne bi tso̱jo̱ ra gabida ra tjuju ra hernán cortés, maske indi pädije ge gatjo da za da o̱t'e ne xi ra nzunda maría trinidad,	nub'u̱ ri m'e̱nji ne ri b'e̱go ya ñämfo̱ bi kuat'i ko ngekagije ne bi tso̱ho̱ ra gabida ra tjuju ra Hernán Cortés, maske indi pädije ge gatjo da za da o̱t'e ne xi ra nsunda María Trinidad,
nubia, unga mfädi ja ra ñäjñu kjamädi ra universidad autónoma del estado de hidalgo.	nubia, unga mfädi ja ra ñäjñu kjamädi ra universidad autónoma del estado de hidalgo.
nugi, ra miguel hernández ge di pe̱tsi ma ngu nuni chiyauhtzinco, ko ra t'ek'ei di udi ko nge'i, nuna m'e̱jnant'ofo di joki go tso̱n'i ko nge'i, ma t'ek'ei bo̱najmu'i nda doctor alonso ruiz, ra nk'ojnate ge gi b'ui nuua ja ra jnini ra quamochtitla.	nugi, ra Miguel Hernández ge di pe̱tsi ma ngu nuni Chiyauhtzinco, ko ra t'ek'ei di udi ko nge'i, nuna m'e̱jnant'ofo di joki go tso̱n'i ko nge'i, ma t'ek'ei bo̱najmu'i nda Doctor Alonso Ruiz, ra nk'ojnate ge gi b'ui nuua ja ra jnini ra Quamochtitla.
nuna je̱m'i bri t'unga mfädi ko ra t'u̱ka ntjint'ant'ofo po ra marcelo díaz salas ne ra luis reyes garcía ja: tialtocan, revista de fuentes para el conocimiento de las culturas indígenas de méxico, vol. vi, 1970, b'ede ra 3, pp. 193-212.	nuna jemi bri t'unga mfädi ko ra t'u̱ka ntjint'ant'ofo po ra Marcelo Díaz Salas ne ra Luis Reyes García ja: Tialtocan, revista de fuentes para el conocimiento de las culturas indígenas de México, vol. vi, 1970, b'ede ra 3, pp. 193-212.
"nuna jñäpi juts'i ja n'a ra je̱m'i fädi ra derecho canonigo ko ra tjuju jñämfo̱ ngu ra ""solicitación al administrar el sacramento de la confesión""."	"nuna jñäpi juts'i ja n'a ra jem'i fädi ra derecho canonigo ko ra tjuju jñämfo̱ ngu ra ""solicitación al administrar el sacramento de la confesión""."
nuna m'e̱jna nt'ofo b'e̱tsi ja ra archivo histórico nacional, madrid, documento 165. bi unga mfädi ja ra nt'ofo ya zubi po ra y'ofo ra tjuju ra arthur j. o. anderson et al.: byond the codices: the nahua view of colonial mexico, berkeley, university of california press, 1976, pp. 181-187.	nuna m'éjna nt'ofo b'étsi ja ra archivo histórico nacional, madrid, documento 165. bi unga mfädi ja ra nt'ofo ya zubi po ra y'ofo ra tjuju ra arthur j. o. anderson et al.: byond the codices: the nahua view of colonial mexico, berkeley, university of california press, 1976, pp. 181-187.
nuna nt'ofo b'e̱tsi ja ra archivo general de indias, sevilla, audiencia de méxico 168, bi unga dra fädi po ra miguel león-portilla ja cultura en peligro, méxico, alianza editorial mexicana, 1976, pp. 102-103.	nuna nt'ofo b'e̱tsi ja ra archivo general de indias, sevilla, audiencia de méxico 168, bi unga dra fädi po ra miguel león-portilla ja cultura en peligro, méxico, alianza editorial mexicana, 1976, pp. 102-103.
nuna pika je̱m'i kja te mä b'e̱tsi ja ra archivo general de la nación, nuua m'onda ne kja ja ra nduntji ya jnini, njabu̱ ngu ya nzaya nuni manjyati ne mar'a ya jnini, o̱t'e gi o̱de ra jñä ra mu̱dimejai.	nuna pika jemi kha te mä be̱tsi ja ra archivo general de la nación, nuwa m'onda ne kha ja ra nduntji ya jnini, njabu̱ ngu ya nzaya nuni manjyati ne mar'a ya jnini, o̱te gi o̱de ra jñä ra mu̱dimejai.
nuua t'unga yojo ya jmä, kuän'ajmä ya ndeznä ne tjuts'i ja n'a ra k'oi mä mäkjuäni ri ntje̱ui n'a ya dänga ra tju̱ajmä manteb'u̱, nuua pede nu'a gatjo ya ts'otjogi bi y'o̱t'a dega fete ra alvarado.	nu'a t'unga yojo ya jmä, kuän'ajmä ya ndeznä ne tsuts'i ja n'a ra k'oi mä mäkjuäni ri ntje̱ui n'a ya dänga ra tsu̱ajmä manteb'u̱, nu'a pede nu'a gatjo ya ts'otjogi bi y'o̱t'a dega fete ra albarado.
nuua ya mu̱di noya ra motolinia, ja ra mu̱di nkoji bi t'o̱t'e ko ra tjuju ra tratado tercero ra dänga b´ede ya mu̱dimejai nuua r´ayo manjyati:	nuwa ya mudi noya ra motolinia, ha ra mudi nkoji bi t'o̱t'e ko ra tjuju ra tratado tercero ra danga b´ede ya mudi mejai nuwa r'ayo manjyati.
"pa da t'unga mfädi gatjo nu'u̱ bi nkja, n'a di ge'u̱ ko ngu fe̱ti nu'a makjuäni mi joki mi tjutsuabi ya jnei ne ya b'ida. b'u̱i man'a ra mfädi da t'o̱t'a ra nt'udi, nu'a ra tjuju ""fe̱ta nu'a makjuäni bi nja nub'u̱ ra tsokat'o̱tamfeni (teatro de la conquista)""."	"pa da t'unga mfädi gatjo nu'u bi nkha, n'a di ge'u ko ngu fe̱ti nu'a makhuäni mi joki mi chucuabi ya jnei ne ya b'ida. b'u man'a ra mfädi da t'o̱t'a ra nt'udi, nu'a ra tjuju ""fe̱ta nu'a makhuäni bi nja nub'u ra tsokat'o̱tamfeni (teatro de la conquista)""."
ra europa -mra nxika jai manteb'u̱, mi pe̱tsa n'a ra nxika b'ede-	ra europa -mra nxiika jai manteb'u̱, mi pe̱tsa n'a ra nxiika b'ede-
ra fernando ramírez mä ge nuna jyodi ri nge̱pu̱ jabu̱ kja n'a ra nikja ra san fernando ne ra ermita dige'a ya mártires dige'a san hipólito,	ra fernando ramirez mä ge nuna jyodi ri nge̱pu̱ jabu̱ kja n'a ra nikja ra san fernando ne ra ermita dige'a ya mártires dige'a san hipólito,
"ra fernando de alva ixtlilxóchitl, fernando de, xiii relación: ""ra ñ'eje ya ñämfo̱ ne ra fu̱di ra nkanfri ra evangelio""."	"ra fernando de alva ixtlilxóchitl, fernando de, xiii relación: ""ra ñ'eje ya ñämfo̱ ne ra fu̱di ra nkanfri ra evangelio""."
ra kuän'ajma ra n luz jiménez bi juts'i ra fernando horkasitas bi unga mfädi ne bi r'atsi nuña jmä), de porfirio díaz zapata, memoria nábuatl de milpa alta, méxico, unam,, instituto de investigaciones históricas, 1974, p. 105	ra kuän'ajma ra n luz jiménez bi juts'i ra fernando horkasitas bi unga mfädi ne bi r'atsi nuña jmä), de porfirio díaz zapata, memoria náhuatl de milpa alta, méxico, unam,, instituto de investigaciones históricas, 1974, p. 105
ra raymundo isidro alavez, bi b'u̱i'i nuni ra boxtha chico, san salvador, estado de hidalgo	ra reymundo isidro alavez, bi b'u̱i'i nuni ra boxtha chiko, san salvador, estado de hidalgo
ra jmä ra fundación de santo tomás ajusco, archivo general de la nación, méxico, ramo de tierras vol. 2676, expediente. 4, archivo histórico de la biblioteca nacional de antropología, colección antigua, vol. 254, fojas 259 r.- 260 v.	ra jmä ra fundación de santo tomás ajusco, archivo general de la nación, méxico, ramo de tierras vol. 2676, expediente. 4, archivo histórico de la biblioteca nacional de antropología, colección antigua, vol. 254, fojas 259 r.- 260 v.
ra makja mra tjuju ra toribio benavente, motolinia,	ra makha mra t'u'u ra toribio benavente, motolinia,
tlauhquechol: ra ts'ints'u̱ xa ntjeni pode ge'a ra flamenco o ra guacamaya, pode ge gatjo ra tje̱nga ts'ints'u̱ ne dänga.	tlawkechol: ra ts'ints'u̱ xa ntjeni pode ge'a ra flamenco o ra wakamaya, pode ge gatjo ra tje̱nga ts'ints'u̱ ne dänga.
xkri tso̱ngä ngostji, kja jejni ya 'ñu; nä'ä rí ma nxamädo, ja nä'ä rí ma mäbo̱za. antes de	OTQ: xkri tso̱ngä ngostji, kja jexni ya 'ñu; nä'ä rí ma nxamädo, ja nä'ä rí ma mäbo̱za. antes de
ya b'e̱go ne ya b'e̱tri di ge'a nu'a ra dänga ndä ra ndada ra tjuju ra esteban de guzmán ra nzaya di gekua m'onda, ra ndada ra hernando pimentel, ra ndada ra antonio cortés, ra ndada xuua (juan) nuna ra mecoyoacan, ra ndada pedro motecuhzoma, me ma r'a ya kuänmi (firmas).	ya b'ego ne ya b'etri di ge'a nu'a ra danga nda ra ndada ra tjuju ra Esteban de Guzmán ra nzaya di gekua m'onda, ra ndada ra Hernando Pimentel, ra ndada ra Antonio Cortés, ra ndada Xuua (Juan) nuna ra Mecoyoacan, ra ndada Pedro Motecuhzoma, me ma r'a ya kuanmi (firmas).
ya kuän' ajmä xa tjogi manteb'u̱e ge xa tjäst'i nu'a gatjo ra ntjandi to'o bi b'e̱di ge xa pu̱ngajñä nuna jmä getbu̱ n'ate ya jñäki ge ñä ya nso̱jo̱ jñäki ne xa y'oni nuna nt'ofo neje ja ra jñäki yazi xada kjä'i , ge'a nuna jñäki fadi ja ra jñämfo ko ra tjuju ra sistema braile.	ya kuän' ajmä xa tjogi manteb'u̱e ge xa tjäst'i nu'a gatjo ra ntjandi to'o bi b'e̱di ge xa pu̱ngajñä nuna jmä getbu̱ n'ate ya jñäki ge ñä ya nso̱jo̱ jñäki ne xa y'oni nuna nt'ofo neje ja ra jñäki yazi xada kjä'i , ge'a nuna jñäki fadi ja ra jñämfo ko ra tjuju ra sistema braile.
ya r'atsanoya ra sahagán, ndoxkjua k'oi florentino, lib. xii, caps. xxix-xli (versión de ángel ma. garibay k.).	ya r'atsanoya ra Sahagán, ndoxkjua k'oi Florentino, lib. xii, caps. xxix-xli (versión de Ángel Ma. Garibay K.).
despwés ya desde k'a ra momento ya k'a ya jíngi bénya'wi já té bimáju̱ k'a ra charroya'wi	"despwés ya desde k'a ra momento ya k'a ya jíngi bénya'wi já té bimáju̱ k'a ra charroya'wi
OTQ: despwés ya desde k'a ra momento ya k'a ya jíngi bénya'wi já té bimáju̱ k'a ra charroya'wi"
despwés ya xo bimu̱fí pe xo diario diario bu̱ nchúi mitsu̱ k'a ra charro mi'óbí k'a ra mikwála	despwés ya xo bimu̱fí pe xo diario diario bu̱ nchúi mitsu̱ k'a ra charro mi'óbí k'a ra mikwála
goparejájé primero 'á k'a ra parte ánk'ú dínant'í	gopareháhé primero 'á k'a ra parte ánk'ú dínant'í
i asta fecha pues ignoro mucho pero másk'ŭ mäkjámá más ndímáignorajéwi	i hasta fecha pues ignoro mucho pero másk'ŭ mäkjámá más ndímáignorajéwi
indu̱odiagí bastante	OTQ: indu̱odiagí baste
inga se̱je̱ ra nntjandi ra manjyati ne ra portuguesa neje ra francesa, inglesa, alemana e italiana,	inga seje ra ndzandi ra manjyati ne ra portuguesa neje ra francesa, inglesa, alemana e italiana,
k'a mädämé para ke mantenigíjé dígotjó mäbäjtsí pues ni modo dísufréjé	k'a mädämé para ke mantenigíjé dígotjó mäbäjtsí pues ni modo dísufréjé
kómá'u̱té ya fuente níjí	kóma'uté ya fuente níjí
ne bi unbabi nduntji ya baba, bi enbabi ge mi ne da ñäui ra ndä (emperador) mi b'u̱i nuni manjyati, ne da jäni ra dänga ts'ofo ra evangelio,	ne vi unvavi nduntzi ya baba, vi envavi ge mi ne da ñäwi ra ndä (emperador) mi b'u̱i nuni manjyati, ne da jäni ra dänga ts'ofo ra evangelio,
normalmente gójo	normalmente góho
panteón ga dó	panteón ga dó
pero de sesenta pantsítjá pa gotjók'ŭ kompletamente xatjó ndímáfădijé	pero de sesenta pantsítjá pa gotjók'ŭ completamente jatjó ndímáfădijé
pero eso sí binújgí mängŭjé kada ná	pero eso sí binújgí mangujé kada ná
"po nuya kja'i to'o mi pede ge fädi ko ra tjuju ya ""cronistas de las indias”"	"po nuya kha'i to'o mi pede ge fädi ko ra tjuju ya ""cronistas de las indias"""
pues este kábádá balewa este mínimo siento sinkwenta	pues este kábaá balewa este mínimo siento sinkwenta
pues nimodo bisufré k'a más ante mäabwelitajé komo mbu̱i enkajoso ra ntsoya	pues nimodo bisufré k'a más ante mäbwelitajé komo mbwi enkajoso ra ntsoya
ra nku̱t'i ra juajni ne ya ñ'udi ntjutsi ra agustin yáñez 2da. edición. biblioteca del estudiante universitario, unam, 1950.	ra nku̱t'i ra huajni ne ya ñ'udi ntjutsi ra agustin yáñez 2da. edición. biblioteca del estudiante universitario, unam, 1950.
solamente ya riko alkansabi	solamente ya riko alkansabi
xi ra tí na ta komedór 'á itsí na ta alimento k'a ra ndăni	xi ra ti na ta comedór 'á itsí na ta alimento k'a ra ndani
xo mitajá ra ntsoya mitá sínko pesos ra béjña dos sinkwenta	xo mitajá ra ntsoya mitá sínko pesos ra béjña dos sinkwenta
xo takja mä sesenta wik'a takja mä sesenta bitajkíjéya'wik'a	xo takha mä sesenta wik'a takha mä sesenta pitajkíjéya'wik'a
á panteón ga dó níjí	á panteón ga dó níjí
ñúdigejña dabadijíya' razo''ya' mientra más dandu̱jté	ñúdigejña dabadijíya' razo'ya' mientra más dandu̱jté
-nu'u̱ dige'u̱ b'u̱i nuni maxey (tolimán ne amealco), dige'u̱ temoaya nuni ra ra jyodi estado de méxico ne mar'a ya jyodi nuni puebla ne veracruz	-nu'u dige'u b'u̱i nuni maxei (tolimán ne amealco), dige'u temoaya nuni ra ra jyodi estado de méxico ne mar'a ya jyodi nuni puebla ne veracruz
ne mätajekitjo di kja getbu̱, ra jñäpi ra joel martinez hernández ne ra jotjo tjuajmä ra natalio hernández xocoyotzin, nuya yojo ya xajnate ri ñ'eje ya y'u̱ dige'u̱ ya ndeznä.	ne mätajekitjo di kja getbu̱, ra jñäpi ra Joel Martínez Hernández ne ra jotjo tjuajmä ra Natalio Hernández Xocoyotzin, nuya yojo ya xajnate ri ñ'eje ya y'u̱ dige'u̱ ya ndeznä.
"-n'ate pa n'a ra zänä de ra r'e̱t'a ma jñäto ""zänä"" mi zo̱ta ya munts'i ya n'ate ya pa ge mi joki ra xihuitl o ""ra m'ede ra kje̱ya"""	"-n'ate pa n'a ra sänä de ra r'e̱t'a ma jñäto ""sänä"" mi zo̱ta ya munts'i ya n'ate ya pa ge mi joki ra xiwitl o ""ra m'ede ra kje̱ya"""
bi ma di gepu̱ jam''u̱ ra ngo pa da ts'itje ya it'adeje (Tlahuano) ba po̱ni nubu̱ tlapechhuan. mra ngo ra izcalli.	bi ma di gepu̱ jam''u̱ ra ngo pa da ts'itje ya it'adeje (Tlahuano) ba po̱ni nubu̱ tlapechhuan. mra ngo ra izcalli.
bi mu̱di da jyoka ya t'u̱kats'u̱fabo̱kja. ge'a ra ntujni bi nkja nuni Coyohuehuetzin ne ma gojo ba nkja.	bi mudi da jyoka ya t'u̱kats'u̱fabo̱kha. ge'a ra ntuxni bi nkha nuni Coyohuehuetzin ne ma gojo ba nkha.
bri tjo ra cuauhnochtli, ra gabida tlacatecco, ra cuapan, ra gabida huitznáhuac, ra makja Amantlan, ne ra makja tlacopan.	OTQ: bri tjo ra kuauhnochtli, ra gavida tlakateko, ra kuapan, ra gavida witsnáwak, ra makha Amantlan, ne ra makha tlakopan.
bri ts'u̱tuabi ja ra y'u̱ga n'a ra nto̱de dega t'u̱ka joga do dega chalchihuite: made mi juts'i n'a ra tsant'i dega k'astabokja.	bri ts'utuabi ja ra y'uga n'a ra nto̱de dega t'u̱ka joga do dega chalchihuite: made mi juts'i n'a ra tsant'i dega k'astabokja.
Castañeda, ra t'u ra Aquiyahualcatecuhtli, m ra ndä nuni tlaxcala.	Castaneda, ra t'u ra Aquiyahualcatecuhtli, m ra ndä nuni Tlaxcala.
Coaíhuitl mra gabida ndeznä nuya mapa digeá ra t'o̱t'ats' okamfeni.	Coaíhuitl mra gabida ndeznä nuya mapa digeá ra t'o̱t'ats' okamfeni.
di gepu̱ ba koi pa nuni ra Xochimilco. nubu̱ ba tu ya kjä'i ya metlatelolco	di gepu ba koi pa nuni ra Xochimilco. nubu ba tu ya kjä'i ya metlatelolco
ebu̱ ba eje man'aki ba te̱nga ra t'o̱jo̱ ra tjuju ra Citlaltépec. Tlacopan, nubia ba o̱t'ra b'u̱i ja ra ndo̱m'ijmu.	ebu ba eje man'aki ba t'enga ra t'ojo ra t'uju ra Citlaltépec. Tlacopan, nubia ba o̱t'ra b'u̱i ja ra ndo̱m'ijmu.
ebu̱ bi dädi ra Cihuacóatl:	ebu bi dädi ra Cihuacóatl
ebu̱ bi ñä ra Cuauhtémoc bi xipabi ra Cihuacóatl:	ebu bi ñä ra Cuauhtémoc bi xipabi ra Cihuacóatl
gojo n'ate ya pa ne ebu̱ bi yopa bo̱ni pa di mani ra Huaxtepec, ra Cuauhnahuac (Cuernavaca).	gojo n'ate ya pa ne ewu bi yopa bo̱ni pa di mani ra Huaxtepec, ra Cuauhnahuac (Cuernavaca).
gue dá nhuat'i mbo kja ra ximjai,	gue dá nhuat'i mbo kha ra ximjai
i nte ra nge'a, ya jmä juts'i ja ra ndäxkjua k'oi ra códice ra ramírez uni nuna b'e̱de mä makjuäni ngu mä ra ntje̱ka b'ede ne ra ndädi nu'a ra nänä mra tjuju ra yacotzin, ra nänä ra ixtlilxóchitl,	i nte ra nge'a, ya jmä juts'i ja ra ndäxkjua k'oi ra códice ra ramírez uni nuna b'e̱de mä makjuäni ngu mä ra ntje̱ka b'ede ne ra ndädi nu'a ra nänä mra tjuju ra yacotzin, ra nänä ra ixtlilxóchitl,
inda jyo ko ra ndäxjua ixtlilxóchtil, ra dada ra Nezahualcóyotl ni ko ra fernando de alva ixtlilxóchitl.	inda jyo ko ra ndäxhua ixtlilxóchtil, ra dada ra Nezahualcóyotl ni ko ra Fernando de Alva Ixtlilxóchitl.
k o ya bu̱' bai, ko ya makahuai,	k o ya bu̱' bai, ko ya makwai,
mi fudi da t'axka ra xudi ba ts'i, bri tját'a ja n'a ra za mi b'ai ja ra ngu ra Ahuizotzin nuni ra Acatliyacapan.	mi fudi da t'axka ra juti ba ts'i, bri tját'a ja n'a ra sa mi b'ai ja ra ngu ra Ahuizotzin nuni ra Acatliyacapan.
mi gu̱t'a ra ñ'u̱ n'a ra makja ge'a mra b'e̱fi mi zu nu'a ra mäka jai mra tjuju ra Yohualichan.	mi gu̱t'a ra ñ'u̱ n'a ra makha ge'a mra b'e̱fi mi zu nu'a ra mäka jai mra tjuju ra Yohualichan.
mi y'o y'oua, mi tuts'i ya bu̱'bai dega za, ne r'a mi jä dega bo̱ja ne ya mahuai.	mi y'o y'ua, mi tuts'i ya bu̱'bai dega za, ne r'a mi jä dega bo̱ha ne ya mahuai.
mra ngu ra Aztautzin ge'a mi kja getbu̱ nuni ra Amáxac.	mra ngu ra Aztautzin ge'a mi kha getbu̱ nuni ra Amáxac.
n'a ra jyo ne man'a bi xokuabi ra debi. ra Cuauhtemoctzin bri xokuabi ra debi ge'a se̱je̱.	n'a ra jyo ne man'a bi xokuabi ra debi. ra Cuauhtemoctzin bri xokuabi ra debi ge'a seje.
ne m'e̱fa bi ma xki jäki ya je dega magabi, ñätsi bi ntsaya ra mahuai ne ra bu̱'bai, bri nkjonda ya bo̱najmu nuni Acachinanco.	ne m'efa bi ma xki jäki ya je dega magabi, ñätsi bi ntsaya ra mahuai ne ra bu'bai, bri nkjonda ya bo̱najmu nuni Acachinanco.
ne nkjabu̱ bri t'ot'e neje ko mar'a ya bo̱najmu mi pe̱tsi ra t'u̱ka tsu̱tui ja ya t'u̱ka jnini, nuyu̱ to'o mi b'e̱pi da t'o̱t'e ngu nuni Xalapan, Tlaxcalan, Tehuantepec, Oaxaca neje mar'a ya bo̱najmu mar'a ya t'u̱ka jnini jabu̱ bi guat'i ya nduste, ya dumantjuju dega k'astaboja, ge ya tjuju ya kristiano [...]	ne ngkabu bri t'ot'e neje ko mar'a ya boŋajmu mi pe̱tsi ra t'u̱ka tsu̱tui ja ya t'u̱ka jnini, nuyu̱ to'o mi b'e̱pi da t'o̱t'e ngu nuni Xalapan, Tlaxcalan, Tehuantepec, Oaxaca neje mar'a ya boŋajmu mar'a ya t'u̱ka jnini ngabu bi guat'i ya nduste, ya dumantjuju dega k'astaboja, ge ya tjuju ya kristiano [...]
ne nu'a ri däme, pu̱ ñ'a'i, nugi ga ma ga tsogi'i nuni Cuetlachcoapan [n'a ra jnini nuni puebla],	ne nu'a ri däme, pu ñ'a'i, nugi ga ma ga tsogi'i nuni Cuetlachcoapan [n'a ra jnini nuni puebla],
ne nu'u̱ bi mani dra ts'okat'o̱t'amfeni nuni Michoacán, Xalisco, Culhuacan ne nuni neje Pánuco, ne nuni Oaxaca, Tehuantepec ne Guatemala, ne nuua ra r'ayo majyati, nub'u̱ bri t'o̱t'a ra mabagi pa dra uadi dra t'o̱t'a nu'a ra ts'okat'o̱t'amfeni inda tsogije se̱je̱.	ne nu'u̱ bi mani dra ts'okat'o̱t'amfeni nuni Michoacán, Jalisco, Culhuacan ne nuni neje Pánuco, ne nuni Oaxaca, Tehuantepec ne Guatemala, ne nuua ra r'ayo majyati, nub'u̱ bri t'o̱t'a ra mabagi pa dra uadi dra t'o̱t'a nu'a ra ts'okat'o̱t'amfeni inda tsogije se̱je̱.
nejege'a ra ngätsi. mi jä ya mpe̱fi dega mabagi,ya nkjom'a te ne ya fu̱nbo̱kja, inte ma mahuai mi jä ni ge'a ya bu'bai.	nehege'a ra ngätsi. mi hä ya mpefi dega mabagi, ya nkjom'a te ne ya fu̱nbo̱kha, inte ma mahuai mi hä ni ge'a ya bu'bai.
njabu̱ bi bo̱nga dega xui. mra ngo nub'u̱ ra Tecuílhuitl bi bo̱nga: nub'u̱ bi kja ya du ja ra r'ani ra deje ya u̱erna.	njabu bi bonga dega xui. mra ngo nub'u ra Tecuílhuitl bi bonga: nub'u bi kja ya du ja ra r'ani ra deje ya uerna.
nub'u̱ bi tjandi ra Tzihuacpopoca, bi t'ena:	nub'u̱ vi tjandi ra Tzihuacpopoka, vi t'ena.
nub'u̱ ya ñämfo̱ bi jandi ge xa ñ'eje nubu̱ da tsu̱di, ge mi tekuabi ra nest'iji, m'estjo bi munts'i bi miji ya mahuai.	nub'u ya ñämfö bi handi ge xa ñ'ehe nubu da tsu̱di, ge mi tekuabi ra nest'iji, m'estho bi munts'i bi miji ya mahuai.
nuna kjä'i inbi tsa bi tjädi makjuäni nu'a ra nt'ani. ingra nge'a nuya pa bi jneki n'a ra jyoya jä'i ra macehual (hombre de pueblo),	nuna kjä'i inbi tsa bi tjädi makhuäni nu'a ra nt'ani. ingra nge'a nuya pa bi jneki n'a ra jyoya jä'i ra masehual (hombre de pueblo)
nuna nte̱nga b'ede ja bri jat'i ra Tzihuacpopocatzin, bi o̱t'e da tjogi ge'a ra ts'e̱y'e̱jmu. inbi bo̱nga nuna nt'o̱t'e bi tsu̱diju̱ ko ma r'a ya b'e̱jni. ma ra ya ñ'ete inbi jopi da kju̱ man'aki ra ñ'u nuya ts'okate. pe nuya inbi joki ra b'ai.	nuna nte̱nga b'ede ja bri jat'i ra Tzihuacpopocatzin, bi o̱t'e da tjogi ge'a ra ts'e̱y'e̱jmu. inbi bo̱nga nuna nt'o̱t'e bi tsu̱diju̱ ko ma r'a ya b'e̱jni. ma ra ya ñ'ete inbi jopi da kju̱ man'aki ra ñ'u nuya ts'okate. pe nuya inbi joki ra b'ai.
nuua di udije ra jñäpi bi nto̱t'e bi nkja ra agosto ra kje̱ya 1595, n'a ra kjä'i mra tjuju ra miguel Hernández, ra me Chiyauhtzinco,	nuua di udije ra jñäpi bi nto̱t'e bi nkja ra agosto ra kje̱ya 1595, n'a ra kjä'i mra tjuju ra miguel Hernández, ra me Chiyauhtzinco.
nuya bo̱najmu ya mem'onda ñätsi bi ñäui ra Cihuacóatl Tlacotzin m'estjo bi tjädi:	nuya bonajmu ya mem'onda ñätsi vi ñäui ra Cihuacóatl Tlacotzin m'estjo vi tjädi.
ra Tlacatécatl mra me Cuauhtitlan ne ra bktri ra mbot'a ngu bri kjapi ya tsat'yo bi zi.	ra Tlacatécatl mra me Cuauhtitlan ne ra b'ktri ra mbot'a ngu bri kjapi ya tsat'yo bi zi.
ra doy'e̱ pajni xki njom'i ko ya chalchihuite.	ra doy'e̱ pajni xki njom'i ko ya chalchihuite.
ra mu̱di ra Cuauhtémoc, ra jmu ra bondo, ra nyojo ra tlatsotzin, ra Cihuacóatl ra njñu ra oquiztzin, ra bo̱najmu ja ra nini ra aztsapotzaltso Mexicapan, ra ngojo ra panitzin, ra bo̱najmu nuni ra Ecatepec,	ra mudi ra Cuauhtémoc, ra jmu ra bondo, ra nyojo ra tlatsotzin, ra Cihuacóatl ra njñu ra oquiztzin, ra bonajmu ja ra nini ra aztsapotzaltso Mexicapan, ra ngojo ra panitzin, ra bonajmu nuni ra Ecatepec,
ra mu̱di ra pa mi o̱t'e ra ngo ra mäkime ra u, ra tjuju ra Huixtocihuatl	ra mudi ra pa mi ote ra ngo ra mäkime ra u, ra tshushu ra Huixtocihuatl
ra nge'a bi mu̱ni ko ra mahuai ja ra xu̱tja nu'a to'o bi umbabi ra kji.	ra nge'a bi muni ko ra mawuai ha ra xutja nu'a to'o bi umbabi ra kji.
ra nyojo, bi tjo ra ndä ra Nauhtla, mra tjuju ra Cohualpopocatzin.	ra nyojo, bi tjo ra ndä ra Nauhtla, mra tjuju ra Cohualpopokatsin.
unga ya ngue̱nda te ra ts'omu̱i mi bu̱'i ne mi kjapi da ntso̱m'i nuya macehualtin, nkjabu̱ mi tjutuabi ya kjä'i mi b'u̱i te ma za	OTQ: unga ya nguenda te ra ts'omwi mi bu'i ne mi kjapi da ntso̱mi nuya masehualtin, nkjabwi mi tjutuabi ya kjä'i mi b'u̱i te ma za
xib'u̱ bri fádi ge nuya je mi kja nuni ra Cuauhchichilco, ja Xaltocan; ge mi pttsi ya ndá.	xib'u bri fádi ge nuya je mi kha nuni ra Cuauhchichilco, ja Xaltocan; ge mi pttsi ya ndá.
xki mbo̱ni nubu̱ ra jyodi ra Cuehuecatitlan,	xki mbo̱ni nubu̱ ra jyodi ra Kuewekatitlan,
xki tjete ra ixtlilxóchitl ne ra ku ra Cohuanacotzin ko ya je dega dänga ndä bi mu̱di da jäni ra joga ts'ofo ya evangelio,	xki tjete ra ixtlilxóchitl ne ra ku ra Cohuanacotzin ko ya je dega dänga ndä bi mudi da jäni ra joga ts'ofo ya evangelio.
ya dänga ñu̱ni nsafi, ya nsafi, ya mahuai, jangu nu'u̱ gatjo xki tagi mbo ja ra jñe.	ya danga ñu̱ni nsafi, ya nsafi, ya mawuai, jangu nu'u̱ gatjo xki tagi mbo ja ra jñe.
bi o̱tuabi nu'a ra makja xki nk'ojni mra tjuju ra alonso ruiz, ge mi y'o nuni juamuxtitan (Huamuxtitlan) nuni ra jyodi guerrero.	bi o̱tuabi nu'a ra makha xki nk'ojni mra tjuju ra alonso ruiz, ge mi y'o nuni huamuxtitan nuni ra jyodi guerrero.
di pädi xajño nuna b'e̱fi neje yojo to'o di pädi da mpe̱fi da y'este nuya joga do majye̱gi ya xito, mra tjuju ra ambetz'ihuay.	di pädi xajño nuna b'efi neje yojo to'o di pädi da mpefi da yeste nuya joga do majye̱gi ya xito, mra tjuju ra ambetz'ihuay.
dra tjoki ra nto̱de, ra ketzal dra b'e̱ nuni Coyohuacan.	dra tjoki ra nto̱de, ra ketzal dra b'e̱ nuni Coyohuacan.
e mi r'ani dega xui ra Cihuacóatl g'ea mi zoni ne mı mafi.	e mi r'ani dega jui ra Cihuacóatl gea mi soni ne mi mafi.
ebu̱ bi gäi jabu̱ mi to̱ge ebu̱ bi yopa ma ja ra jnini ra Cuetaxtlan,	ebu bi gäi xabu mi toge ebu bi yopa ma xa ra jnini ra Cuetaxtlan,
ge'a ra mu̱di ra tjuju ra Hernando, ra nge'a nkjabu̱ mra tjuju ra takjä ra Cortés neje nkjabu̱ mra tjuju ra ndä Católico ne ra ku ra Cohuanacotzin bi tjutuabi ra Pedro po ra Pedro Alvarado ra nge'a ra takjä,	ge'a ra mudi ra tjuju ra Hernando, ra nge'a nkjabu̱ mra tjuju ra takjä ra Cortés neje nkjabu̱ mra tjuju ra ndä Católico ne ra ku ra Cohuanacotzin bi tjutuabi ra Pedro po ra Pedro Alvarado ra nge'a ra takjä,
ma n'a mi b'ai nuni teotletso, jabu̱ ra ñ'u̱ pa manjuäntjo pa da zo̱ni nuni ra peñón (Tepetzinco).	ma n'a mi b'ai nuni teotlecho, jabu ra ñ'u pa manhuäntjo pa da soni nuni ra peñón (Tepetzinco).
"mi tso̱jo̱ getbu̱ ra fu̱nga t'o̱jo̱, jabu̱ mi tjutuabi ""takjón ra nxu̱ni, nkjabu̱ bi jutuabi ya ndeznä ya b'e̱jnanoya bi pe̱jni ra ts'e̱y'e̱jmu, mi gu̱t'a ra ñ'u ra Tzihuacpopocatzin, bi bo̱nga ja ra ñ'u."	"mi tsojo getbu ra funga tojo, jabu mi tjutuabi ""takjón ra nxuni, nkjabu bi jutuabi ya ndeznä ya b'ejnanoya bi pejni ra tseyejmu, mi gut'a ra ñ'u ra Tzihuacpopocatzin, bi bonga ja ra ñ'u."
mra ku ra Cacamatzin mra bo̱najmu nuni Tetzcoco mri ñ'oui va kjä'i mi y'o mpaja.	mra ku ra Cacamatzin mra bonajmu nuni Tetzcuco mri ñ'oui va kjä'i mi y'o mpaha.
n'a ra nto̱de dega chalchihuite, xi m'et'e dega ze̱ka do, neje mi pe̱tsi n'a ra tsant'i de ga k'astabokja.	n'a ra nto̱de dega chalchihuite, xi m'et'e dega se̱ka do, neje mi pe̱tsi n'a ra tsant'i de ga k'astabokha.
ne nduntji ya ambetz'ihuay ne mar'a joga do mi pe̱tsi ra mu'ui:	ne ndunthi ya ambetz'ihuay ne mar'a joga do mi petsi ra mu'ui.
neje n'a ya tje̱stji dega mboťahuaido.	neje n'a ya tse̱stji dega mboťahuaido.
nuna bi o̱t'a ra ntso̱m'i ra nge'a neje nuya ya b'e̱datsi bi tsini ko ra Cortés ne ra Cohuanacotzin ne ra ixtlilxóchitl xki nsofo pa ra ixtlilxóchitl da gu̱ka ya kjä'i ge mi zu ya jyodi, nkjabu̱ mi pe̱jna akjuä da t'o̱t'e.	nuna bi o̱t'a ra ntso̱m'i ra nge'a neje nuya ya b'e̱datsi bi tsini ko ra Cortés ne ra Cohuanacotzin ne ra ixtlilxóchitl xki nsofo pa ra ixtlilxóchitl da gu̱ka ya kjä'i ge mi zu ya jyodi, nkjabu̱ mi pe̱jna akjuä da t'o̱t'e.
nuna nt'o̱t'e bi ntjandi xa nts'ogi njabu̱ bri tjutuabi, bi ena ge mra nzu̱te ko ma m'u̱jai ra nzu̱te ne mi tjutsuabi ko ya mpe̱bi dega mabagì, jabu̱ jmä ge n'a di ge'u̱ bi y'e̱nga n'a ra do, ko nge'a bi jyo, nu'u̱ mar'a ya b'e̱go ge mä ge nu'u̱ se̱je̱ ya ñämfo̱ bi jyo bi mu̱tu'a n'a ra mahuai ja ri ngati bi mu̱tuabi n'a ra nzu̱ni.	nuna nt'ote bi ntjandi xa nts'ogi njabu bri tjutuabi, bi ena ge mra nzu̱te ko ma m'ujai ra nzu̱te ne mi tjutsuabi ko ya mpebi dega mabagi, jabu jmä ge n'a di ge'u bi y'enga n'a ra do, ko nge'a bi jyo, nu'u mar'a ya b'ego ge mä ge nu'u seje ya ñämfo bi jyo bi mu'tu'a n'a ra mahuai ja ri ngati bi mu'tuabi n'a ra nzu̱ni.
ra Cuauhtémoc, Tlacotzin, ra Cihuacóatl, Oquiztzin, Panitzin, Motelhuihtzin; nuna bi sofo ra tsortés nuni Coyoacan, nu'u̱ to'o mi pädi yojo ya jñäki ngu'a ra jerónimo aguilar ra malintzin.	ra Kuauhtémok, Tlakotsin, ra Sihuakóatl, Okuistin, Panitsin, Moteluihtsin; nuna bi sofo ra tsorhtés nuni Koyoakan, nu'u̱ to'o mi pädi yoho ya ñäki ngu'a ra Jerónimo Aguilar ra Malintsin.
t'ena ge ya macehual [ya kjä'i b'u̱i ja ra jyoya]	t'ena ge ya masehual [ya kä'i b'wi ha ra jyoya]
"xki tjokuabi nuya jotjo ts'ints'u̱ mra tjuju ra ""tlauhquecho"" ne “tzinitzcan zacuan"","	"xki tjokuabi nuya jotjo ts'ints'u̱ mra tjuju ra ""tlauhquecho"" ne ""tzinitzcan zacuan""."
-¿te be'a gi mä nu'i Cihuacóatl?	-¿te be'a gi mä nu'i Cihuacóatl?
bi k'ajni ko ya dänga ñuni nzafi ne bi tjetse ko ya makahuai nuya otomi geb'u̱ bi japi bi b'e̱di, bi mä nuyu̱:	bi k'ajni ko ya dänga ñuni nzafi ne bi tsetse ko ya makawaj nuya otomi geb'u̱ bi japi bi b'edi, bi mä nuyu̱:
da tjuts'i ya nkjot'ijñä ( )	da tsuts'i ya ngkot'ijñä
da umbabije te da zi, da kjapabije nduntji ma zu.	da umbabixe te da si, da kjapabixe nduntzi ma zu.
ebu̱ bi mä nuna b'e̱fi xa tjoki xajño bi kjohya ra ts'e̱y'e̱jmu.	ebu bi mä nuna b'efi xa choki xajño bi kjohya ra tse'y'ejmu.
"fernando alva ixtlilxóchitl, xiii nkjändajmä ""ra ñ'eje ya ñämfo̱ ne ra mu̱di ra joga ts'ofo ra evangelio."""	"Fernando Alva Ixtlilxóchitl, xiii nkjändajmä ""ra ñ'eje ya ñämfo̱ ne ra mu̱di ra joga ts'ofo ra evangelio."""
ga kjuatiju̱ nu'a juts'i nkjani, ya ts'ojä'i, ra carranza, ge xa o̱t'a ya ts'okuate pa gekagiju̱; ga o̱t'e da nkja ra ts'e̱di ma munts' ne njabu̱ ga tsu̱diju̱ da nkja nu'a ra joga tsu̱tui, da nkja ra jai, ra jñegi ne ra joga ts'u̱tui;	ga kʷatihu nu'a juts'i nkjani, ya ts'oxä'i, ra carranza, ge xa ot'a ya ts'okuate pa gekatihu; ga ot'e da nkja ra ts'edi ma munts' ne njabu ga tsu'dihu da nkja nu'a ra joga tsu'tui, da nkja ra jai, ra ñegi ne ra joga ts'u'tui;
gatjo ya jyoyakjä'i mi b'u̱i ja ra jnini bi jandi.	gatjo ya jyoyakjä'i mi b'u̱i ja ra jnini bi jandi.
ja bi jäni ra ñ'udi, ma kjä'iju̱ bi ent'i gatjo majye̱gi nuya nzu̱te	ja bi jäni ra ñ'udi, ma kjä'iju̱ bi ent'i gatjo maxye̱gi nuya nsu̱te
ja n'aa nza̱tjo xudi ra pale berto, bi bo̱ni nda jyonga te nda nzimxidi ngetjo nda zi ya jme jyaxtjo mi u̱xa ya u, ua ngu mi nzäi mi nkajui yá jme nuya chukju̱ xa jogi ja nuya 'bomuja̱i nts'ät'i, nt'o̱kuä;	ja n'aa nza̱tjo jhudi ra pale berto, bi bo̱ni nda jyonga te nda nzimxidi ngetjo nda zi ya jme jyaxtjo mi u̱xa ya u, ua ngu mi nzäi mi nkajui yá jme nuya chukju̱ xa jogi ja nuya 'bomuja̱i nts'ät'i, nt'o̱kuä;
ja nubia di ndäki, di ndändiñäjmu, di ma ga ts'u̱tsa'i ri y'e, ga ndäne'i ra nge'a nu'a'i ma makjaje, ra bartolomé lópez, nub'u̱ mi nkjuäni ma b'e̱jña inbi nkjuäni ja nubu̱ mi xaxi pa da o̱t'a ya tso̱mfen	ja nubia di ndäki, di ndändiñäjmu, di ma ga ts'u̱tsa'i ri y'e, ga ndäne'i ra nge'a nu'a'i ma makjaje, ra Bartolomé López, nub'u̱ mi nkjuäni ma b'e̱jña inbi nkjuäni ja nubu̱ mi xaxi pa da o̱t'a ya tso̱mfen
ja ya t'u̱ka ze̱ki tjuts'i n'a tu̱kitjo nuna tjogi ge bi juxa ra fernando alva ixtlilxóchitl, nu'a b'e̱tsi ra xiiii nkjondajmä.	ja ya t'u̱ka se̱ki tsuts'i n'a tu̱kitjo nuna tsogi ge bi juxa ra Fernando Alva Ixtlilxóchitl, nu'a b'e̱tsi ra xiiii nkjondajmä.
jabu̱ ga kju̱he nuyu̱ (ya tenochcas) te gi joniju̱?	jabu̱ ga kju̱he nuyu̱ (ya tenochcas) te gi joniju̱?
jam'u̱ gatjo ya kjuän'ajmä ge nuua xa ze̱ti ri ñ'eje dige'a ya noya ya mu̱dimejai ja ra jñä ya ndeznä, nuna tjuju ri uni inga se̱je̱ ra n'atsanoya pa da fädi ra jñämfo̱, ingi ri me̱udi dige'a ra jmä fu̱oti dige'a nuna ra jñäki ra netzajualtsoyotl. ne ra cuauhtémoc.	jam'u̱ gatjo ya kjuän'ajmä ge nuua xa se̱ti ri ñ'eje dige'a ya noya ya mu̱dimejai ja ra jñä ya ndeznä, nuna tjuju ri uni inga se̱je̱ ra n'atsanoya pa da fädi ra jñämfo̱, ingi ri me̱udi dige'a ra jmä fu̱oti dige'a nuna ra jñäki ra necajualtsoyotl. ne ra kuauhtémok.
mi jneki ngu ma kjä'iju̱ ngabu̱ mri jneki.	mi jneki ngu ma kjä'iju̱ ngabu̱ mri jneki.
nduntji bri kjojya, bri tjuxpabi gatjo nu'a mi o̱t'abi ra b'edi, ko nge'u̱ bi m'u̱i ne mi t'umbabi ya t'ixu:	nduntji bri kʰojya, bri tʰuxpabi gatjo nu'a mi o̱t'abi ra b'edi, ko ŋe'u̱ bi m'u̱i ne mi t'umbabi ya t'ixu.
ngu mra me̱ti, nu'a r'a hyodi, jabu mi y'o, n'a ngu n'a mi kjohya mi mfe̱m'a xinxi xi mi kjohya ya ndäte, mi tjede n'a ngu n'a mi jñu̱fi ne mi fe̱m'a ya xinxi: xi mi b'u̱i mpaja.	ngu mra meti, nu'a ra hyodi, jabu mi yo, na ngu na mi kjohya mi mfe̱m'a xinxi xi mi kjohya ya ndäte, mi tjede na ngu na mi jñu̱fi ne mi fe̱m'a ya xinxi: xi mi b'u̱i mpaja.
nkjabu̱ ri ñ'eje ya kje̱ya inda m'e̱di, inda mpumfri, ga nzäi ga pe̱tsi nugagiju̱ ja ma mfeniju̱, ga pe̱tsi nugagiju̱, ra bätsi dige'u̱, ya b'e̱to, ya ntsaniku, ya mbänga b'e̱to ne to'o dra ñ'epu̱, to'o majye̱gigiju̱, ma kjiju̱, ya ku̱ju̱.	nkjabu ri ñ'eje ya kje̱ya inda m'e̱di, inda mpumfri, ga nzäi ga pe̱tsi nugagiju̱ ja ma mfeniju̱, ga pe̱tsi nugagiju̱, ra bätsi dige'u̱, ya b'e̱to, ya ntsaniku, ya mbänga b'e̱to ne to'o dra ñ'epu̱, to'o majye̱gigiju̱, ma kjiju̱, ya ku̱ju̱.
nu xä otj'u̱, ma gä ñ'kjäju̱	nu xä otj'u̱, ma kä ñ'kjäju̱
nuga̱ xi di ne'i, jindi pädi jankja...	nuga xi di ne'i, jindi pädi jankja...
num'u̱ di kjojyaju̱, nkueju̱, nts'o̱miju̱, tsuju ne pa da t'o̱xkäju̱ di jojñu̱ nu ya nt'u̱i xi di 'yooju̱ (¡!). nuya da nt'ot'i ko ra dänt'ot'í	num'u̱ di kjoyaju̱, nkueju̱, nts'o̱miju̱, tsuju ne pa da t'o̱xkäju̱ di joyñu̱ nu ya nt'u̱i xi di 'yooju̱ (¡!). nuya da nt'ot'i ko ra dänt'ot'í
nuna bi kjojya ja ra mabagi,	nuna vi kʰoxʰya xa ra mabagi
nuya jñu o gojoya pa bi b'u̱i nubu̱ bi xitsuabi ra kjäpadeje nduntji ya kjä'i, ngu xa t'ena.	nuya jñu o gojoya pa vi b'u̱i nubu̱ vi xitsuabi ra kjäpadeje nduntji ya kjä'i, ngu xa t'ena.
nuya tsat'io mi b'et'o, mi gu̱t'a ra ñ'u, mi teni, ya xiñu mi kju̱ts'i pa mañä, xi mi päjä gatjo mi jandi mi nest'iji: mi tu̱ta ya kjijni	nuya tsat'io mi b'et'o, mi güta ra ñ'u, mi teni, ya xiñu mi küts'i pa mañä, xi mi päjä gatjo mi jandi mi nest'iji: mi tu̱ta ya kjijni
pe, nu'i ndada nu'i ma t'ek'ei ra makja, nub'u̱ nu'i ingi zugagije, ¿jankja, nuua, ra jyo di ge'a, ga tsogi nubu̱ [nu'a ma b'e̱jña]?	pe, nu'i ndada nu'i ma t'ek'ei ra makha, nub'u̱ nu'i ingi sugagije, ¿jankha, nuwa, ra jyo di ge'a, ga tsogi nubu̱ [nu'a ma b'e̱jña]?
r'a ya kjä'i mi b'u̱i ja ra ngumi kja nunu ja ra jnini ri mankjuäntjo pa da tsoni nubu̱ ra amáxac,	r'a ya kjä'i mi b'u̱i ja ra ngumi kja nunu ja ra jnini ri mankhuäntjo pa da tsoni nubu̱ ra amáxac
ra nge'a di o̱t'a nuna noya ra ts'u̱tui ne gatjo to'o da guat'a ja ma jyoje, nu'u̱ to'o da ne, da me̱tsi n'a ra joga m'u̱i ne da m'u̱i mankjuäntjä. ja nubu̱ xa mabu̱ ma noya ge di pe̱tsi ra tsa, dega joga kjä'i ne dega jogat'o̱t'antujni	ra nge'a di o̱t'a nuna noya ra ts'u̱tui ne gatjo to'o da guat'a ja ma jyoje, nu'u̱ to'o da ne, da me̱tsi n'a ra joga m'u̱i ne da m'u̱i mankjuäntjä. ja nubu̱ xa mabu̱ ma noya ge di pe̱tsi ra tsa, dega joga kjä'i ne dega jogat'o̱t'antujni
ra ngejna nuna pa bi ma n'a ra ñ'u mankjuäntjo.	ra ngejna nuna pa vi ma n'a ra ñ'u mankhuäntjo.
ra njñu ne ra ngästsi ra b'ist'ofo di juts'iju̱ ja nuna ze̱ki b'ist'ofo, ri ñ'eje ra vii nkjondajmä ra chimalpain,	ra ñu ne ra ngästsi ra b'ist'ofo di juts'iju̱ ja nuna se̱ki b'ist'ofo, ri ñ'eje ra vii nkjondajmä ra chimalpain,
ra ntjädi ra cuitlahuacatzin bi ena ge ina da o̱t'e nuya bi b'e̱pabi ya nso̱jo̱kjä'i,	ra ntjädi ra kuitlahuakatzin bi ena ge ina da o̱t'e nuya bi b'e̱pabi ya nso̱ho̱kjä'i,
ra nyojo nu'a mi zu ra tepoztlan; ra njñu ra me tizatlan, ra nkjojo mi ñ'eje nuni huehuetlan ne ra nku̱ta mra dänga mictlan.	ra nyojo nu'a mi zu ra tepoztlán; ra ñu ra me tizatlán, ra nkojo mi ñ'eje nuni wehuetlán ne ra nkuta mra danga miktlan.
ri ñ'udi xajño nubia jankja beni ya metlaxcala bi do̱m'i mpaja nuya nso̱jo̱ kjä'i.	ri ñ'udi xajño nubia jankja veni ya metlaxcala bi dom'i mpaha nuya nso̱ho̱ kjä'i.
t'ena ge inbi unga mfädi pa gatjo ya kjä'i mi ñ'oui, ge nuna ndada ra marqués da ñ'eje dra jmu ja ma jaije, da ja me̱ti nu'a di pe̱tsije neje dra kjakagije ga mpe̱fije ra jai ge bi umbabi o bi jänbabi ya joga jai ya n'añ'o jnini.	t'ena ge inbi unga mfädi pa gatjo ya kä'i mi ñ'oui, ge nuna ndada ra markés da ñ'eje dra jmu ja ma jaije, da ja me̱ti nu'a di pe̱tsije neje dra käkagije ga mpe̱fije ra jai ge bi umbabi o bi jämbabi ya joga jai ya n'añ'o ñini.
xi mi taxki ra ñ'u, imbi tsa da r'anga n'a, jo̱nse̱je̱ mi taxka n'a ja ra bo̱jai. ya y'ofadi mi kju̱t'atjo.	xi mi takki ra ñ'u, impi tsa da r'anga n'a, jonseje mi takka n'a ja ra bojai. ya y'ofadi mi kjut'atjo.
ya dänga mfu̱nga bo̱kjä bi ntjo, bi kot'i ko ya majkjuai, mi zu̱m'i neje ko ya t'e̱nga ts'u̱t'abo̱kja.	ya dánga mfu̱nga bokjä bi ntjo, bi kot'i ko ya majkhuai, mi zum'i neje ko ya t'enga ts'u̱t'abo̱kja.
ya r'atsanoya ra sajagún mi mä jankja mi yopa tsini. ya ndeznä bi nkoji inda ñ'udi. mi jatatjo pa bi mu̱di ra ntujni	ya r'atsanoya ra sahagún mi mä jankha mi yopa tsini. ya ndeznä bi nkoji inda ñ'udi. mi jatatjo pa bi mu̱di ra ntujni
ya zi b'e̱jña mi ägi ja ya b'a ne ja ya ngo̱de, nuya ñ'o̱jo̱ mbo ja ya ne, ja ya nkjom'ajudi.	ya xi b'e̱hña mi ägi ha ya b'a ne ha ya ngu̱de, nuya ñ'o̱ho̱ mbo ha ya ne, ha ya ngkom'ajudi.
bi boxro xi 'be̱ts'ina, bido'u̱ ro 'yu̱ni 'na, xi bi bo̱x ro hkjua 'na, bido'u̱ ro ts'ii 'na, xi bo̱xro ts'äre 'na. ge'bu̱ go min pu̱n doja 'na.	bi boxro xi 'be̱ts'ina, bido'u̱ ro 'yu̱ni 'na, xi bi bo̱x ro hkua 'na, bido'u̱ ro ts'ii 'na, xi bo̱xro ts'äre 'na. ge'bu̱ go min pu̱n doha 'na.
bi ma mankjuäntjo jabu̱ mi b'u̱i ra ts'e̱y'e̱jmu bi xipabi;	bi ma mankhwäntjo jabu̱ mi b'u̱i ra ts'eh'e̱jmu bi xipabi;
bri kjuajni po nuya dra jmu.	bri kjuajni po nuya dra jmu.
di to̱m'ihe ra ñ'etji pa nugagije, n'a ra pa ngu ma n'a ra pa tjogi nekagije di juadije ra nge'a indi tse̱tije nuna b'u̱i t'o̱t'e ko ngekagije man'año ya ntjo, t'e̱nts'igije tji ma jaije ma me̱tije, ju̱kagije ga mpe̱fije nduntji, b'e̱kagije ga jut'ije xduntji ya bokja, n'a ngu n'a ra pa nuna nkjut'i di o̱t'eje man'a te ma tjaije di tuje.	di tom'ihe ra ñ'etji pa nugagije, n'a ra pa ngu ma n'a ra pa chogi nekagije di huadije ra nge'a indi tse̱tije nuna b'u̱i t'o̱t'e ko ngekagije man'año ya ntjo, t'e̱nts'igije tji ma jaije ma me̱tije, ju̱kagije ga mpe̱fije nduntji, b'e̱kagije ga jut'ije xduntji ya bokja, n'a ngu n'a ra pa nuna nkjut'i di o̱t'eje man'a te ma tjaije di tuje.
gatjo nuna jai ja nuna r'ayo ximjai nkjabu̱ bi tjutuabi nuya nso̱jo̱jä'i inbi tsa bi tjutuabi man'a ra tjuju.	gatjo nuna jai ja nuna r'ayo ximjai nkjabu̱ bi tjutuabi nuya nso̱jo̱jä'i inbi tsa bi tjutuabi man'a ra tjuju.
ja mi tso nde, bi mu̱di bi nkja n'a ra jneki ngu nkjagiju̱ dega kjä'i, bi t'ot'e ra b'ai ngu dega kjä'i,	ja mi tso nde, bi mudi bi nkja n'a ra jneki ngu nkjagiju dega kjä'i, bi t'ot'e ra b'ai ngu dega kjä'i,
ma bo̱najmu'ije: nuna b'e̱fi ga tsokagije sta kjuatihe gatjo: gi nuti nuua, xa jño bo̱najmu.	ma bonajmu'ije: nuna befi ga tsokagije sta khuatihe gatjo: gi nuti nuua, xa jño bonajmu.
mi mä dega ts'e̱dira jñä tso̱pu da ts'o̱jo̱bu nuya nzo̱jo̱kjä'i ga jandiju̱ te ma ts'e̱di pe̱tsi, ra nge'a ma akjuä ra quetzalcohuatl b'u̱i nuua ko ngekagiju̱,	mi mä dega tse̱dira jñä tso̱pu da tso̱jo̱bu nuya nzo̱jo̱kjä'i ga jandiju̱ te ma tse̱di pe̱tsi, ra nge'a ma akjuä ra quetzalcohuatl b'u̱i nuua ko ngekagiju̱,
ne ya nt'u̱i, jankja di tjuts'i ya nt'ofo, nkjap'u̱ neje mä 'ra ya mpeu̱i da fats'i di nt'ot'i ra jñäjñu	ne ya nt'wi, jankha di chuchi ya nt'ofo, nkjap'u neje mä 'ra ya mpewi da fats'i di nt'oti ra jñajñu
nub'u̱ nu'i ingi kjapi da bo̱nga nu'a ra makja ja nu'a ra jnini, ¿jankja ra yotui, ga tso̱gi nubu̱ ma b'e̱jña? o̱t'a r'ato ya kje̱ya bi mu̱di [ra makja ra bartolomé lópez]	nub'u̱ nu'i ingi kjapi da bo̱nga nu'a ra makha ha nu'a ra jnini, ¿jankha ra yotui, ga tso̱gi nubu̱ ma b'e̱jña? o̱t'a r'ato ya kje̱ya bi mu̱di [ra makha ra bartolomé lópez]
pa ga b'u̱i mpaja ne ga o̱t'e n'a ra nkjondajmä gatjo nu'a ga jandi.	pa ga b'i mpaha ne ga o̱t'e n'a ra nkjondajmä gatjo nu'a ga jandi.
r'a nuna mi ntjandi ngu nu'a ma tjänkjuaju̱ (ychtlilmatli), xi mra nts'o, mi kuet'e ja ya ngo̱,	r'a nuna mi ntʰandi ngu nu'a ma tʃänkjuahua (yɨtlilmatli), xi mra ntso, mi kuet'e ja ya ngɔ̱,
xa zägi mpaja, nub'u̱ xa nkjabu̱ xa kjapabi ma zu ne inte xa t'o̱tuabi nub'u̱ inda kjapi xa po̱jo̱ bi ya kue̱ ra nge'a ya kjä'i xi mra no̱t'e ne mra jyotekjä'i,	xa sägi mpaha, nub'u̱ xa ngkabu̱ xa kjapabi ma zu ne inte xa t'o̱tuabi nub'u̱ inda kjapi xa po̱ho̱ bi ya kue̱ ra nge'a ya kjä'i xi mra no̱t'e ne mra jyotekjä'i,
y'o, ri ma ne gi xipabiju̱ ya metlaxcala ge ma r'a ya me̱ti kjä'i ne ri ajuäju̱, ge nu'a ga mä ge xa eje nuua ma jaiju̱, ge di umbabije ma ntjädije.	y'o, ri ma ne gi xipabihu̱ ya metlaxkala ge ma r'a ya me̱ti kjä'i ne ri ajuähu̱, ge nu'a ga mä ge xa eje nuwa ma jaihu̱, ge di umbabije ma ntjädije.
¿te da o̱t'e ma kjä'iju̱ sta b'e̱diju̱?	¿te da o̱t'e ma kä'ihu̱ sta b'e̱dihu̱?
-da ts'iua:... ri ñ'eje ge'a ma nkjueij'u̱. da o̱t'eje ya ñ'o̱te ko ya je̱m'i, ya ñ'o̱t'eje ko ya ntuts'i. da o̱ts'e̱ ra b'e̱na noya.	-da tsiwa:... ri ñeje ge'a ma nkjueij'u̱. da oteje ya ñote ko ya jemi, ya ñoteje ko ya ntuts'i. da otse ra beña noya.
-dom'i ma akjuäju̱ ge inda yu̱t'a ja ma nguju̱ nuju̱ to'o e̱nts'i pa tji ne da jokuabi ra jonanjyo nub'u̱ sta ne da jyoki ya inda za.	-dom'i ma akwäwü ge inda yu̱t'a ja ma nguwü nuwü to'o e̱nc'i pa tji ne da jokuabi ra jonanjyo nub'u̱ sta ne da jyoki ya inda za.
-o̱t'a ra mäte gi o̱deju̱, kja gi b'ai nuuaju̱. mont'a ya ngo akjuä; ri kjuat'i ra ngo ga tsunda ma akjuäje.	-o̱t'a ra mäte gi o̱dehu, kha gi b'ai nuwaju. mont'a ya ngo akhuä; ri kwat'i ra ngo ga tsunda ma akhuäje.
-xa jño, di b'u̱ije nkjamädije.	"-xa jño, di b'u̱ije nkjamädije.
OTQ: -xa jño, di b'u̱ije nkjamädije."
-¿nguande nkjabu̱ ga mäu gra kjuäju̱?	-¿nguande nkjabu̱ ga mäu gra kjuäju̱?
-ñ'emabagi, ya gabida, ya kjä'iju̱ gi pädi ra ntuni ra mem'onda ba ejeju̱ ga te̱niju̱ma nzu̱teju̱. ko ya mätsa mi te̱je̱, ko ya bu̱'bai ko ngatjo ra ts'e̱di mi te̱je̱ ra ñ'u.	-ñ'emabagi, ya gabida, ya kjä'iju̱ gi pädi ra ntuni ra mem'onda ba ejeju̱ ga te̱niju̱ma nzu̱teju̱. ko ya mätsa mi te̱je̱, ko ya bu̱'bai ko ngatjo ra ts'e̱di mi te̱je̱ ra ñ'u.
bi tse̱ti nuna ngot'i ra m'onda, ngu pede ra dänga b'ede, ya k'oi ne ya nkjändajmä, ngu nu'a ra jmä ra alonso axayaca, gojo n'ate ma pa bi nzo̱t'e nuna pa.	bi tse̱ti nuna ngot'i ra m'onda, ngu pede ra dänga b'ede, ya k'oi ne ya nkjändajmä, ngu nu'a ra jmä ra alonso axayaca, gojo n'ate ma pa bi nzo̱t'e nuna pa.
into y'o mankjuäntjo, into pa ri nektjo.	OTQ: into y'o mankhwänto, into pa ri nekto.
nub'u̱ ndi umbabije ma nkjut'ije xki nzäi ndi da'ije, mi adi n'a tu̱ki neje nub'u̱ ndi unije ya k'astaboja mi jäni made n'a tu̱ki [...]	nub'u̱ ndi umbabixe ma nkjut'ixe xki nzäi ndi da'ixe, mi adi n'a tu̱ki neje nub'u̱ ndi unixe ya k'astaboja mi jäni made n'a tu̱ki [...]
ya miñ'o ko ngejna jmä ri kjojya,	ya miñ'o ko ngejna jma ri kjoya,
bi tso̱jso̱ ra ngo ma akjuäju̱: nubia da fu̱di da guadi ra r'e̱t'a ra pa.	bi tsojso ra ngo ma akjuäju: nubia da fudi da guadi ra re̱t'a ra pa.
