INALI	OTS
"-pasadores: ""ya nts'äza xi mra nts'u̱t'i mi t'e̱ni ko n'a ra t'e̱nga ts'u̱t'a bo̱ja mi thutuabi ra ballesta""."	"-pasadores: ""ya nts'äza xi mra nts'u̱t'i mi t'e̱ni ko n'a ra t'e̱nga ts'u̱t'a bokja mi tjutuabi ra ballesta""."
cantares mexicanos, biblioteca nacional de méxico, ya nt'ofo 1628 bis, folio 16 v.	cantares mexicanos, biblioteca nacional de méxico, ya nt'ojo 1628 bis, folio 16 v.
"ebu̱ bi bo̱ni, bi meui nuni nonohualco, ha ra ngu ra b'ongui habu̱ ra gabida ne ra malintzin ne ""ra hyadi"" (alvarado) ne ra sandoval."	"ebu̱ bi bo̱ni, bi mejui nuni nonohualco, ja ra ngu ra b'ongui habu̱ ra gabida ne ra malintzin ne ""ra kjadi"" (alvarado) ne ra sandoval."
gi handi ra nt'ofo ra thuhu ra crónicas de la conquista	gi jandi ra nt'ofo ra tjuju ra crónicas de la conquista
guzmán. ha ya he̱m'i b'e̱tsa je̱ya manteb'u̱ di ge nuua m'onda ne ya hyo, nu'a ra hmä ra 12-conejo (1530) ge xa hmä ge xibú bi yut'i ha ra culhuacan ya ndeznä, nda pablo xochiquetzin, motelchiuhtzin ne ra guzman.	guzmán. ja ya je̱m'i b'e̱tsa je̱ya manteb'u̱ di ge nuua m'onda ne ya hyo, nu'a ra hmä ra 12-conejo (1530) ge xa hmä ge xibú bi jut'i ja ra kulhuacan ya ndeznä, nda pablo xochiquetzin, motelchiuhtzin ne ra guzman.
ha ga ñ'udihu̱ ra nt'ofo ya ñämfo̱ po ra nthuts'i ra doctor garibay,	ja ga ñ'udiju̱ ra nt'ofo ya ñämfo̱ po ra njuts'i ra doctor garibay,
ha nu'a hyodi nubia thutuabi ra san martin.	ja nu'a kjodi nubia tjutuakji ra san martin.
he̱mi unga mfädi ha ra t'u̱ka hnini habu̱ b'u̱i ya jä'i teni ra división ra arenas, 27 ra abril ra je̱ya 1918, ra m'ets'a he̱m'i ra zapata, b'e̱tsi ha ra universidad nacional autónoma de méxico, expediente 29.	je̱mi unga mfädi ja ra t'u̱ka jnini habu̱ b'u̱i ya kjä'i teni ra división ra arenas, 27 ra abril ra je̱ya 1918, ra m'ets'a je̱m'i ra zapata, b'e̱tsi ja ra universidad nacional autónoma de méxico, expediente 29.
"m'e̱fa ha ra hñuti bri thätuabi na ra hñe xki tagiri mo̱te, nehe bri jom'a ra xu̱tha ko n'a ra t'axa dutu mra thuhuu ra ""campanillante""."	"m'e̱fa ja ra jñuti bri tjätuabi na ra jñe xki tagiri mo̱te, neje bri kjom'a ra xu̱tha ko n'a ra t'axa dutu mra tjuhuu ra ""campanillante""."
ma dada'ihe gra ts'u̱tui, di ne gi pädi ge ma me̱t'o instä thogihe nuna thogi gatho ya mapa xki r'ani, bi juat'i ko ngeke nu̱'u ri b'e̱go, ri me̱fi ya ñämfo̱, ra nge'a majuäni ra hernando cortés ra ndä gabida,	ma kjada'ihe gra ts'u̱tui, di ne gi pädi ge ma me̱t'o instä tjogihe nuna tjogi gatjo ya mapa xki r'ani, bi kjuat'i ko ngeke nu̱'u ri b'e̱go, ri me̱fi ya ñämfo̱, ra nge'a majuäni ra hernando cortés ra ndä gabida,
mi b'u̱i ya mu̱dimehai mi ñä ra ndeznä ne habu̱ ra hnini dige'a gatho ra nxiki m'onda ngu r'a ya yaqui b'u̱i nuni sonora ne ya maya ri ñ'ehe nuni yucatán ra nge bi guat'i ha ra tuhni bi nja nuua m'onda fädi ko ra thuhu ra revolución mexicana ya je̱ya 1910-1919.	mi b'u̱i ya mu̱dimehaj mi ñä ra ndeznä ne habu̱ ra jnini dike'a gatjo ra nxiki m'onda ngu r'a ja jaqui b'u̱i nuni sonora ne ja maja ri ñ'eje nuni yucatán ra nje bi guat'i ja ra tujni bi nja nuua m'onda fädi ko ra tjuju ra revolución mexicana ya je̱ja 1910-1919.
mi fo̱tuabi ya ts'u̱tnibo̱ja mi thutuabi ya hñämfo̱ ra pasadores nehe ya bo̱zna ko ya nzafi.	mi fo̱tuakji ya ts'u̱tnibokja mi tjutuakji ya hñämfo̱ ra pasadores neje ya bo̱zna ko ya nzafi.
n'a nt'udi di ge'a nuya nthoki bri t'o̱t'e ha ya hñä ya ndeznä ra ngätsi ra nthebe nje̱ya ra r'e̱t'a ma gu̱to (s. xix), r'a ya hnini ngu ra xicontepec (villa juárez) nuna hyodi kohi nuni puebla.	n'a nt'udi di ge'a nuya ntjoki bri t'o̱t'e ja ya hñä ya ndeznä ra ngätsi ra njebe nje̱ja ra r'e̱t'a ma gu̱to (s. xix), r'a ya jnini ngu ra xicontepec (villa juárez) njuna hjodi koji nuni puebla.
"n'a ra t'axa dutu mi pe̱tsi ya k'oi ra ixki, nuna mra thuhu hñämfo̱ ""campaneante resonador""."	"n'a ra t'axa dutu mi pe̱tsi ya k'oi ra ixki, nuna mra tjuju hñämfo̱ ""campaneante resonador""."
ne ri mpe̱fi ha ra dängan gu nt'udi ra thuhu ra facultad de estudios superiores, acatlán, unam,	ne ri mkje̱fi ja ra dängan gu nt'udi ra tjuhu ra facultad de estudios superiores, acatlán, unam,
nthandi gatho nu'a ra munts'i ra thuhu hñämfo̱ ra globalización ge 'a po̱ts'e dega nest'ihi, nuna y'o̱te to̱m'i da nja ra ntho̱mäte.	nthandi gatjo nu'a ra munts'i ra tjuju jñämfo̱ ra globalización ge 'a po̱ts'e dega nest'ihi, nuna y'o̱te to̱m'i da nja ra ntjo̱mäte.
nu'a ma r'a ya jä'i mi pädi nuña b'e̱fi bri b'e̱pabi xa hyoki yoho ya mpe̱fi mi fädi ko ra thuhu ra amosqueador ko ya xi ya ts'ints'u̱ xi sta hotho, gi hutsuabi made dige'a n'a ra zänä dega k'astaboja	nu'a ma r'a ya kjä'i mi pädi nuña b'e̱fi bri b'e̱pabi xa hjoki yojo ya mpe̱fi mi fädi ko ra tjuju ra amosqueador ko ya xi ya ts'ints'u̱ xi sta jotjo, gi hjutsuabi made dige'a n'a ra zänä dega k'astabokja
"nu'a ra munts'a jä'i bi te̱ni bi zipabi man'a ya b'ede, mi t'ena ge ya jä'i xki b'u̱i nubu̱ inbi pe̱tsi ra ts'e̱di nu'a mi mä pe m'e̱fa bi japi bi nxaxni ya tsu̱tui ne n'a ra diputado mi pe̱tsi ra mfeni xki kot'i mra thuhu ra josé maría lozano, bi y'onga ra hmä pa mar'a ya ñ'oui bi nxanxi: ""ri mo̱te ra thits'i mi udi ra emiliano zapata, nehe bri fädi ngu ra atila nuna bri nju̱tsi [...] nu'a bi fädi ngu mi he̱gi ya b'e̱go ne'a bi mä da uni da nja pa gatho, ingi jot'i [...]"	"nu'a ra munts'a kjä'i bi te̱ni bi zipabi man'a ya b'ede, mi t'ena ge ya kjä'i xki b'u̱i nubu̱ inbi pe̱tsi ra ts'e̱di nu'a mi mä pe m'e̱fa bi japi bi nxaxni ya tsu̱tui ne n'a ra diputado mi pe̱tsi ra mfeni xki kot'i mra tjuhu ra josé maría lozano, bi y'onga ra hmä ja mar'a ya ñ'oui bi nxanxi: ""ri mo̱te ra thits'i mi udi ra emiliano zapata, neje bri fädi ngu ra atila nuna bri nju̱tsi [...] nu'a bi fädi ngu mi je̱gi ya b'e̱go ne'a bi mä da uni da nja ja gatho, ingi jot'i [...]"
nu'u̱ to'o ñä ra ndenzä ha r'e̱t'a ma r'at'o ya estados.	nu'u̱ to'o ñä ra ndenzä ja r'e̱t'a ma r'atjo ya estados.
nub'u̱ ri m'e̱hni ne ri b'e̱go ya ñämfo̱ bi juat'i ko ngekagihe ne bi tso̱ho̱ ra gabida ra thuhu ra hernán cortés, maske indi pädihe ge gatho da za da o̱t'e ne xi ra nzunda maría trinidad,	nub'u̱ ri m'e̱jni ne ri b'e̱go ya ñämfo̱ bi kjuat'i ko ngekajije ne bi tjo̱jo̱ ra gabida ra tjuhu ra hernán cortés, maske indi pädihe ge gatjo da za da o̱t'e ne xi ra nzunda maría trinidad,
nubia, unga mfädi ha ra ñähñu jamädi ra universidad autónoma del estado de hidalgo.	nubia, unga mfädi ja ra ñähño jamädi ra universidad autónoma del estado de hidalgo.
nugi, ra miguel hernández ge di pe̱tsi ma ngu nuni chiyauhtzinco, ko ra t'ek'ei di udi ko nge'i, nuna m'e̱hnant'ofo di hoki go tso̱n'i ko nge'i, ma t'ek'ei bo̱nahmu'i nda doctor alonso ruiz, ra nk'ohnate ge gi b'ui nuua ha ra hnini ra quamochtitla.	nugi, ra miguel hernández ge di pe̱tsi ma ngu nuni chijauhtzinco, ko ra t'ek'ei di udi ko nge'i, nuna m'e̱jnant'ofo di kjoji go tso̱n'i ko nge'i, ma t'ek'ei bo̱najmu'i nda doctor alonso ruiz, ra nk'ojñate ge gi b'ui nuua ja ra jnini ra quamochtitla.
nuna he̱m'i bri t'unga mfädi ko ra t'u̱ka nthint'ant'ofo po ra marcelo díaz salas ne ra luis reyes garcía ha: tialtocan, revista de fuentes para el conocimiento de las culturas indígenas de méxico, vol. vi, 1970, b'ede ra 3, pp. 193-212.	nuna je̱m'i bri t'unga mfädi ko ra t'u̱ka njint'ant'ofo po ra marcelo díaz salas ne ra luis reyes garcía ja: tialtocan, revista de fuentes para el conocimiento de las culturas indígenas de méxico, vol. vi, 1970, b'ede ra 3, pp. 193-212.
"nuna hñäpi huts'i ha n'a ra he̱m'i fädi ra derecho canonigo ko ra thuhu hñämfo̱ ngu ra ""solicitación al administrar el sacramento de la confesión""."	"nuna hñäpi huts'i ja n'a ra je̱m'i fädi ra derecho canoniko ko ra tjuju hñämfo̱ ngu ra ""solicitación al administrar el sacramento de la confesión""."
nuna m'e̱hna nt'ofo b'e̱tsi ha ra archivo histórico nacional, madrid, documento 165. bi unga mfädi ha ra nt'ofo ya zubi po ra y'ofo ra thuhu ra arthur j. o. anderson et al.: byond the codices: the nahua view of colonial mexico, berkeley, university of california press, 1976, pp. 181-187.	nuna m'e̱jna nt'ofo b'e̱tsi ja ra archivo histórico nacional, madrid, documento 165. bi unga mfädi ja ra nt'ofo ya zubi po ra y'ofo ra tjuhu ra arthur j. o. anderson et al.: byond the codices: the nahua view of colonial mexico, berkeley, university of california press, 1976, pp. 181-187.
nuna nt'ofo b'e̱tsi ha ra archivo general de indias, sevilla, audiencia de méxico 168, bi unga dra fädi po ra miguel león-portilla ha cultura en peligro, méxico, alianza editorial mexicana, 1976, pp. 102-103.	nuna nt'ofo b'e̱tsi ja ra archivo general de indias, sevilla, audiencia de méxico 168, bi unka dra fädi po ra miguel león-portilla ja kultura en peligro, méxico, alianza editorial mexicana, 1976, pp. 102-103.
nuna pika he̱m'i ja te mä b'e̱tsi ha ra archivo general de la nación, nuua m'onda ne ja ha ra ndunthi ya hnini, njabu̱ ngu ya nzaya nuni manhyati ne mar'a ya hnini, o̱t'e gi o̱de ra hñä ra mu̱dimehai.	nuna pika je̱m'i ja te mä b'e̱tsi ja ra archivo general de la nación, nuua m'onda ne ja ja ra ndunthi ya jnini, njabu̱ ngu ya nzaya nuni manhjati ne mar'a ya jnini, o̱t'e gi o̱de ra hñä ra mu̱dimehai.
nuua t'unga yoho ya hmä, kuän'ahmä ya ndeznä ne thuts'i ha n'a ra k'oi mä mäjuäni ri nthe̱ui n'a ya dänga ra thu̱ahmä manteb'u̱, nuua pede nu'a gatho ya ts'othogi bi y'o̱t'a dega fete ra alvarado.	nuua t'unga yojo ya hmä, kuän'ahmä ya ndeznä ne thuts'i ja n'a ra k'oi mä mäjuäni ri nthe̱ui n'a ya dänga ra thu̱ahmä manteb'u̱, nuua pede nu'a gatjo ya ts'otjogi bi y'o̱t'a dega fete ra alvarado.
nuua ya mu̱di noya ra motolinia, ha ra mu̱di nkohi bi t'o̱t'e ko ra thuhu ra tratado tercero ra dänga b´ede ya mu̱dimehai nuua r´ayo manhyati:	nuua ya mu̱di noya ra motolinia, ja ra mu̱di nkoji bi t'o̱t'e ko ra tjuju ra tratado tercero ra dänga b´ede ya mu̱dimejai nuua r´ayo manjati:
"pa da t'unga mfädi gatho nu'u̱ bi nja, n'a di ge'u̱ ko ngu fe̱ti nu'a majuäni mi hoki mi thutsuabi ya hnei ne ya b'ida. b'u̱i man'a ra mfädi da t'o̱t'a ra nt'udi, nu'a ra thuhu ""fe̱ta nu'a majuäni bi nja nub'u̱ ra tsokat'o̱tamfeni (teatro de la conquista)""."	"pa da t'unga mfädi gatjo nu'u̱ bi nja, n'a di ge'u̱ ko ngu fe̱ti nu'a majuäni mi hoki mi tjutsuabi ya hnei ne ya b'ida. b'u̱i man'a ra mfädi da t'o̱t'a ra nt'udi, nu'a ra tjuhu ""fe̱ta nu'a majuäni bi nja nub'u̱ ra tsokat'o̱tamfeni (teatro de la conquista)""."
ra europa -mra nxika hai manteb'u̱, mi pe̱tsa n'a ra nxika b'ede-	ra europa -mra nxika hai mantekju̱, mi pe̱tsa n'a ra nxika b'ede-
ra fernando ramírez mä ge nuna hyodi ri nge̱pu̱ habu̱ ja n'a ra nija ra san fernando ne ra ermita dige'a ya mártires dige'a san hipólito,	ra fernando ramírez mä ge nuna hjodi ri nje̱pu̱ habu̱ ja n'a ra nija ra san fernando ne ra ermita dike'a ja mártires dike'a san hipólito,
"ra fernando de alva ixtlilxóchitl, fernando de, xiii relación: ""ra ñ'ehe ya ñämfo̱ ne ra fu̱di ra nkanfri ra evangelio""."	"ra fernando de alva ixtlilxóchitl, fernando de, xiii relación: ""ra ñ'eje ya ñämfo̱ ne ra fu̱di ra nkanfri ra evangelio""."
ra kuän'ahma ra n luz jiménez bi huts'i ra fernando horkasitas bi unga mfädi ne bi r'atsi nuña hmä), de porfirio díaz zapata, memoria nábuatl de milpa alta, méxico, unam,, instituto de investigaciones históricas, 1974, p. 105	ra kuän'ajma ra n luz jiménez bi kjuts'i ra fernando horkasitas bi unga mfädi ne bi r'atsi nuña hmä), de porfirio díaz zapata, memoria nábuatl de milpa alta, méxico, unam,, instituto de investigaciones históricas, 1974, p. 105
ra raymundo isidro alavez, bi b'u̱i'i nuni ra boxtha chico, san salvador, estado de hidalgo	ra rajmundo isidro alavez, bi b'u̱i'i nuni ra bokjtha chico, san salvador, estado de hidalgo
ra hmä ra fundación de santo tomás ajusco, archivo general de la nación, méxico, ramo de tierras vol. 2676, expediente. 4, archivo histórico de la biblioteca nacional de antropología, colección antigua, vol. 254, fojas 259 r.- 260 v.	ra jmä ra fundación de santo tomás ajusco, archivo general de la nación, méxico, ramo de tierras vol. 2676, expediente. 4, archivo histórico de la biblioteca nacional de antropología, colección antigua, vol. 254, fojas 259 r.- 260 v.
ra makja mra thuhu ra toribio benavente, motolinia,	ra makja mra tjuju ra toribio benavente, motolinia,
tlauhquechol: ra ts'ints'u̱ xa ntheni pode ge'a ra flamenco o ra guacamaya, pode ge gatho ra the̱nga ts'ints'u̱ ne dänga.	tlauhquechol: ra ts'ints'u̱ xa njeni pode ge'a ra flamenco o ra guacamaya, pode ge gatjo ra the̱nga ts'ints'u̱ ne dänga.
xkri tso̱ngä ngosthi, ja hehni ya 'ñu; nä'ä rí ma nxamädo, ha nä'ä rí ma mäbo̱za. antes de	xkri tso̱ngä ngostji, ja jehni ya 'ñu; nä'ä rí ma nxamädo, ja nä'ä rí ma mäbo̱za. antes de
ya b'e̱go ne ya b'e̱tri di ge'a nu'a ra dänga ndä ra ndada ra thuhu ra esteban de guzmán ra nzaya di gekua m'onda, ra ndada ra hernando pimentel, ra ndada ra antonio cortés, ra ndada xuua (juan) nuna ra mecoyoacan, ra ndada pedro motecuhzoma, me ma r'a ya kuänmi (firmas).	ya b'e̱go ne ya b'e̱tri di ge'a nu'a ra dänga ndä ra njada ra tjuju ra esteban de guzmán ra nzaya di gekua m'onda, ra njada ra hernando pimentel, ra njada ra antonio cortés, ra njada xuua (juan) njuna ra mecoyoacan, ra njada pedro motecuhzoma, me ma r'a ya kuänmi (firmas).
ya kuän' ahmä xa thogi manteb'u̱e ge xa thäst'i nu'a gatho ra nthandi to'o bi b'e̱di ge xa pu̱ngahñä nuna hmä getbu̱ n'ate ya hñäki ge ñä ya nso̱ho̱ hñäki ne xa y'oni nuna nt'ofo nehe ha ra hñäki yazi xada jä'i , ge'a nuna hñäki fadi ha ra hñämfo ko ra thuhu ra sistema braile.	ya kuän' ahmä xa tjogi manteb'u̱e ge xa tjäst'i nu'a gatjo ra njandi to'o bi b'e̱di ge xa pu̱ngakjñä nuna hmä getbu̱ n'ate ya hñäki ge ñä ya njso̱jo̱ hñäki ne xa y'oni nuna nt'ofo neje ja ra hñäki yazi xada kjä'i , ge'a nuna hñäki fadi ja ra hñämfo ko ra tjuhu ra sistema braile.
ya r'atsanoya ra sahagán, ndoxjua k'oi florentino, lib. xii, caps. xxix-xli (versión de ángel ma. garibay k.).	ya r'atsanoya ra sahagán, ndoxkjua k'oi florentino, lib. xii, caps. xxix-xli (versión de ángel ma. garibay k.).
despwés ya desde k'a ra momento ya k'a ya híngi bénya'wi já té bimáhhu̱ k'a ra charroya'wi	despwés ya desde k'a ra momento ya k'a ya híngi bénja'wi já té bimájju̱ k'a ra charroja'wi
despwés ya xo bimu̱fí pe xo diario diario bu̱ nchúi mitsu̱ k'a ra charro mi'óbí k'a ra mikwála	despwés ya xo bimu̱fí pe xo diario diario bu̱ njúi mitju̱ k'a ra charro mi'óbí k'a ra mikwála
gopareháhé primero 'á k'a ra parte ánk'ú dínant'í	goparejáje primero 'á k'a ra parte ánk'ú tínant'í
i asta fecha pues ignoro mucho pero másk'ŭ mäjámá más ndímáignorahéwi	i asta fecha pues ignoro mucho pero másk'ŭ mäjákjá más ndímáignorajéwi
indu̱odiagí bastante	indu̱odjagí bastante
inga se̱he̱ ra nnthandi ra manhyati ne ra portuguesa nehe ra francesa, inglesa, alemana e italiana,	inga se̱je̱ ra njthandi ra manjati ne ra portuguesa neje ra francesa, inglesa, alemana e italiana,
k'a mädämé para ke mantenigíhé dígothó mäbähtsí pues ni modo dísufréhé	k'a mädämé para ke mantenikjíhé dígotjó mäbähtsí pues ni modo dísufréjé
kómá'u̱té ya fuente níhí	kómá'utje ya fuente níhí
ne bi unbabi ndunthi ya baba, bi enbabi ge mi ne da ñäui ra ndä (emperador) mi b'u̱i nuni manhyati, ne da häni ra dänga ts'ofo ra evangelio,	ne bi unbabi nduntji ya baba, bi enbabi ge mi ne da ñäui ra ndä (emperador) mi b'u̱i nuni manjati, ne da häni ra dänga ts'ofo ra evangelio,
normalmente góho	normalmente kjójo
panteón ga dó	panteón ga kjó
pero de sesenta pantsíthá pa gothók'ŭ kompletamente xathó ndímáfădihé	pero de sesenta pantsíthá pa kotjók'ŭ kompletamente xatjó ndímáfadijé
pero eso sí binúhgí mängŭhé kada ná	pero eso sí bikjúhgí mäkjŭhé kada ná
"po nuya ja'i to'o mi pede ge fädi ko ra thuhu ya ""cronistas de las indias"""	"po nuya kjä'i to'o mi peke ge fädi ko ra tjuju ya ""cronistas de las indias"""
pues este kábádá balewa este mínimo siento sinkwenta	pues este kábádá balewa este mínimo sjento sinkwenta
pues nimodo bisufré k'a más ante mäabwelitahé komo mbu̱i enkahoso ra ntsoya	pues nimodo bisufré k'a más ante mäabwelitajé komo mbu̱i enkajoso ra ntsoya
ra nku̱t'i ra huahni ne ya ñ'udi nthutsi ra agustin yáñez 2da. edición. biblioteca del estudiante universitario, unam, 1950.	ra nku̱t'i ra kjuahni ne ya ñ'udi ntjutji ra agustin yáñez 2da. edición. biblioteca del estudiante universitario, unam, 1950.
solamente ya riko alkansabi	solamente ya riko alkansakji
xi ra tí na ta komedór 'á itsí na ta alimento k'a ra ndăni	xi ra tí na ta komedór 'á itsí na ta alimento k'a ra njăni
xo mitahá ra ntsoya mitá sínko pesos ra béhña dos sinkwenta	xo mitakjá ra ntsoya mitá sínko pesos ra bjejña dos sinkwenta
xo taja mä sesenta wik'a taja mä sesenta bitahkíhéya'wik'a	xo taja mä sesenta wik'a taja mä sesenta bitakjíhéya'wik'a
á panteón ga dó níhí	á panteón ga jó níjí
ñúdigehña dabadihíya' razo''ya' mientra más dandu̱hté	ñúdikejhña dabadijíya' razo''ya' mientra más dandju̱hté
-nu'u̱ dige'u̱ b'u̱i nuni maxey (tolimán ne amealco), dige'u̱ temoaya nuni ra ra hyodi estado de méxico ne mar'a ya hyodi nuni puebla ne veracruz	-nu'u̱ dike'u̱ b'u̱i nuni maxey (tolimán ne amealco), dike'u̱ temoaja nuni ra ra jodi estado de méxico ne mar'a ya jodi nuni puebla ne veracruz
ne mätahekitho di ja getbu̱, ra hñäpi ra joel martinez hernández ne ra hotho thuahmä ra natalio hernández xocoyotzin, nuya yoho ya xahnate ri ñ'ehe ya y'u̱ dige'u̱ ya ndeznä.	ne mätahekjitho di ja getbu̱, ra hñäpi ra joel martinez hernández ne ra jotho tjuahmä ra natalio hernández xocoyotzin, nuya yojo ya xahnate ri ñ'eje ya y'u̱ dike'u̱ ja ndeznä.
"-n'ate pa n'a ra zänä de ra r'e̱t'a ma hñäto ""zänä"" mi zo̱ta ya munts'i ya n'ate ya pa ge mi hoki ra xihuitl o ""ra m'ede ra je̱ya"""	"-n'ate pa n'a ra zänä de ra r'e̱t'a ma hñäto ""zänä"" mi zo̱ta ya munts'i ya n'ate ja pa ge mi hoki ra xihuitl o ""ra m'ede ra je̱ya"""
bi ma di gepu̱ ham''u̱ ra ngo pa da ts'ithe ya it'adehe (Tlahuano) ba po̱ni nubu̱ tlapechhuan. mra ngo ra Izcalli.	bi ma di gekju̱ jam''u̱ ra ngo pa da ts'itje ya it'adeje (Tlahuano) ba po̱ni nubu̱ tlapekjjuan. mra ngo ra Izcalli.
bi mu̱di da hyoka ya t'u̱kats'u̱fabo̱ja. ge'a ra ntuhni bi nja nuni Coyohuehuetzin ne ma goho ba nja.	bi mu̱di da joka ya t'u̱kats'u̱fabokja. ge'a ra ntuhni bi nja nuni Coyohuehuetzin ne ma gojo ba nja.
bri tho ra cuauhnochtli, ra gabida tlacatecco, ra cuapan, ra gabida huitznáhuac, ra makja Amantlan, ne ra makja tlacopan.	bri tjo ra cuauhnochtli, ra gabida tlacatecco, ra cuapan, ra gabida huitznáhuac, ra makja Amantlan, ne ra makja tlacopan.
bri ts'u̱tuabi ha ra y'u̱ga n'a ra nto̱de dega t'u̱ka hoga do dega chalchihuite: made mi huts'i n'a ra tsant'i dega k'astaboja.	bri ts'u̱tuakji ja ra y'u̱ga n'a ra nto̱de dega t'u̱ka hoga do dega chalchihuite: made mi huts'i n'a ra tsant'i dega k'astabokja.
Castañeda, ra t'u ra Aquiyahualcatecuhtli, m ra ndä nuni tlaxcala.	Castañeda, ra t'u ra Akjiyahualkatekujtli, m ra ndä nuni tlaxcala.
Coaíhuitl mra gabida ndeznä nuya mapa digeá ra t'o̱t'ats' okamfeni.	Coaíhuitl mra kjabida ndeznä nuya mapa dikejá ra t'o̱t'ats' okjamfeni.
di gepu̱ ba koi pa nuni ra Xochimilco. nubu̱ ba tu ya jä'i ya metlatelolco	di kjepu̱ ba koi pa nuni ra Xochimilco. nubu̱ ba tu ya kjä'i ya metlatelolco
ebu̱ ba ehe man'aki ba te̱nga ra t'o̱ho̱ ra thuhu ra Citlaltépec. Tlacopan, nubia ba o̱t'ra b'u̱i ha ra ndo̱m'ihmu.	ebu̱ ba eje man'aki ba te̱nga ra t'o̱jo̱ ra tjuhu ra Citlaltépec. Tlacopan, nubia ba o̱t'ra b'u̱i ja ra ndo̱m'ijmu.
ebu̱ bi dädi ra Cihuacóatl:	ebu̱ bi kädi ra Cihuacóatl:
ebu̱ bi ñä ra Cuauhtémoc bi xipabi ra Cihuacóatl:	ebu̱ bi ñä ra Cuauhtémoc bi kjipabi ra Cihuacóatl:
goho n'ate ya pa ne ebu̱ bi yopa bo̱ni pa di mani ra Huaxtepec, ra Cuauhnahuac (Cuernavaca).	gojo n'ate ya pa ne ebu̱ bi jopa bo̱ni pa di mani ra Huaxtepec, ra Cuauhnahuac (Cuernavaca).
gue dá nhuat'i mbo ja ra ximhai,	gue dá njuat'i mbo ja ra kjimjai,
i nte ra nge'a, ya hmä huts'i ha ra ndäxjua k'oi ra códice ra ramírez uni nuna b'e̱de mä majuäni ngu mä ra nthe̱ka b'ede ne ra ndädi nu'a ra nänä mra thuhu ra yacotzin, ra nänä ra ixtlilxóchitl,	i nte ra nje'a, ya hmä huts'i ja ra ndäxkjua k'oi ra códice ra ramírez uni nuna b'e̱je mä majuäni ngu mä ra nthe̱ka b'ede ne ra ndädi nu'a ra nänä mra tjuhu ra yacotzin, ra nänä ra ixtlilxóchitl,
inda hyo ko ra ndäxjua ixtlilxóchtil, ra dada ra Nezahualcóyotl ni ko ra fernando de alva ixtlilxóchitl.	inda hyo ko ra ndäxkjua ixtlilxóchtil, ra jada ra Nezahualcóyotl ni ko ra fernando de alva ixtlilxóchitl.
k o ya bu̱' bai, ko ya makahuai,	k o ya bu̱' baji, ko ya makajuai,
mi fudi da t'axka ra xudi ba ts'i, bri thát'a ha n'a ra za mi b'ai ha ra ngu ra Ahuizotzin nuni ra Acatliyacapan.	mi fudi da t'axka ra xudi ba ts'i, bri tját'a ja n'a ra za mi b'ai ja ra ngu ra Ahuizotzin nuni ra Acatliyacapan.
mi gu̱t'a ra ñ'u̱ n'a ra makja ge'a mra b'e̱fi mi zu nu'a ra mäka hai mra thuhu ra Yohualichan.	mi gu̱t'a ra ñ'u̱ n'a ra makja ge'a mra b'e̱fi mi zu nu'a ra mäka jai mra tjuhu ra Yohualichan.
mi y'o y'oua, mi tuts'i ya bu̱'bai dega za, ne r'a mi hä dega bo̱ja ne ya mahuai.	mi y'o y'oua, mi tuts'i ya bu̱'bai dega za, ne r'a mi hä dega bokja ne ya majua.
mra ngu ra Aztautzin ge'a mi ja getbu̱ nuni ra Amáxac.	mra ngu ra Aztautzin ge'a mi ja ketbu̱ nuni ra Amáxak.
n'a ra hyo ne man'a bi xokuabi ra debi. ra Cuauhtemoctzin bri xokuabi ra debi ge'a se̱he̱.	n'a ra kjo ne man'a bi xokuakji ra debi. ra Cuauhtemoctzin bri xokuakji ra debi ge'a se̱je̱.
ne m'e̱fa bi ma xki häki ya he dega magabi, ñätsi bi ntsaya ra mahuai ne ra bu̱'bai, bri njonda ya bo̱nahmu nuni Acachinanco.	ne m'e̱fa bi ma xki häki ja je dega magabi, ñätsi bi ntsaya ra majuae ne ra bu̱'bai, bri njonda ja bo̱najmu nuni Acachinanco.
ne njabu̱ bri t'ot'e nehe ko mar'a ya bo̱nahmu mi pe̱tsi ra t'u̱ka tsu̱tui ha ya t'u̱ka hnini, nuyu̱ to'o mi b'e̱pi da t'o̱t'e ngu nuni Xalapan, Tlaxcalan, Tehuantepec, Oaxaca nehe mar'a ya bo̱nahmu mar'a ya t'u̱ka hnini habu̱ bi guat'i ya nduste, ya dumanthuhu dega k'astaboja, ge ya thuhu ya kristiano [...]	ne njabu̱ bri t'otje neje ko mar'a ya bo̱najmu mi pe̱tsi ra t'u̱ka tsu̱tui ja ya t'u̱ka jnini, nuyu̱ to'o mi b'e̱pi da t'o̱tje ngu nuni Xalapan, Tlaxcalan, Tehuantepec, Oaxaca neje mar'a ya bo̱najmu mar'a ya t'u̱ka jnini habu̱ bi guat'i ya nduste, ya dumanthuhu dega k'astabokja, ge ya tjuhu ya kristiano [...]
ne nu'a ri däme, pu̱ ñ'a'i, nugi ga ma ga tsogi'i nuni Cuetlachcoapan [n'a ra hnini nuni puebla],	ne nu'a ri däme, pu̱ ñ'a'i, nugi ga ma ga tjogi'i nuni Cuetlachcoapan [n'a ra jnini nuni puebla],
ne nu'u̱ bi mani dra ts'okat'o̱t'amfeni nuni Michoacán, Xalisco, Culhuacan ne nuni nehe Pánuco, ne nuni Oaxaca, Tehuantepec ne Guatemala, ne nuua ra r'ayo mahyati, nub'u̱ bri t'o̱t'a ra mabagi pa dra uadi dra t'o̱t'a nu'a ra ts'okat'o̱t'amfeni inda tsogihe se̱he̱.	ne nu'u̱ bi mani dra ts'okajt'o̱t'amfeni nuni Michoacán, Xalisco, Culhuacan ne nuni neje Pánuco, ne nuni Oaxaca, Tehuantepec ne Guatemala, ne nuua ra r'ayo majyati, nub'u̱ bri t'o̱t'a ra mabaki pa dra uadi dra t'o̱t'a nu'a ra ts'okajt'o̱t'amfeni inda tjogihe se̱je̱.
nehege'a ra ngätsi. mi hä ya mpe̱fi dega mabagi,ya njom'a te ne ya fu̱nbo̱ja, inte ma mahuai mi hä ni ge'a ya bu'bai.	nehege'a ra ngätsi. mi hä ya mpe̱fi dega mabaki,ya njom'a te ne ya fu̱nbo̱kja, inte ma majuae mi hä ni ge'a ya bu'bai.
njabu̱ bi bo̱nga dega xui. mra ngo nub'u̱ ra Tecuílhuitl bi bo̱nga: nub'u̱ bi ja ya du ha ra r'ani ra dehe ya u̱erna.	njabu̱ bi bo̱nja dega xui. mra ngo nub'u̱ ra Tecuílhuitl bi bo̱nja: nub'u̱ bi ja ya du ja ra r'ani ra dehe ya u̱erna.
nub'u̱ bi thandi ra Tzihuacpopoca, bi t'ena:	nub'u̱ bi tjandi ra Tzihuacpopoca, bi t'ena:
nub'u̱ ya ñämfo̱ bi handi ge xa ñ'ehe nubu̱ da tsu̱di, ge mi tekuabi ra nest'ihi, m'estho bi munts'i bi mihi ya mahuai.	nub'u̱ ya ñämfo̱ bi jandi ge xa ñ'eje nubu̱ da tsu̱di, ge mi tekuabi ra nest'ihi, m'estjo bi munts'i bi miji ya majua.
nuna jä'i inbi tsa bi thädi majuäni nu'a ra nt'ani. ingra nge'a nuya pa bi hneki n'a ra hyoya jä'i ra macehual (hombre de pueblo),	nuna kjä'i inbi tsa bi tjädi majuäni nu'a ra nt'ani. ingra nge'a nuya pa bi hneki n'a ra hjoya kjä'i ra macehual (hombre de pueblo),
nuna nte̱nga b'ede ha bri hat'i ra Tzihuacpopocatzin, bi o̱t'e da thogi ge'a ra ts'e̱y'e̱hmu. inbi bo̱nga nuna nt'o̱t'e bi tsu̱dihu̱ ko ma r'a ya b'e̱hni. ma ra ya ñ'ete inbi hopi da ju̱ man'aki ra ñ'u nuya ts'okate. pe nuya inbi hoki ra b'ai.	nuna nte̱nga b'ede ja bri hat'i ra Tzihuacpopocatzin, bi o̱t'e da tjogi ge'a ra ts'e̱j'e̱hmu. inbi bo̱nga nuna nt'o̱t'e bi tsu̱diju̱ ko ma r'a ya b'e̱jni. ma ra ya ñ'ete inbi jokpi da kju̱ man'aki ra ñ'u nuya ts'okate. pe nuya inbi jokji ra b'ai.
nuua di udihe ra hñäpi bi nto̱t'e bi nja ra agosto ra je̱ya 1595, n'a ra jä'i mra thuhu ra miguel hernández, ra me Chiyauhtzinco,	nuua di udihe ra hñäpi bi nto̱t'e bi nja ra agosto ra je̱ya 1595, n'a ra kjä'i mra tjuhu ra miguel hernández, ra me Chiyauhtzinco,
nuya bo̱nahmu ya mem'onda ñätsi bi ñäui ra Cihuacóatl Tlacotzin m'estho bi thädi:	nuya bojnahmu ya mem'onda ñätsi bi ñäui ra Cihuacóatl Tlacotzin m'estho bi tjädi:
ra Tlacatécatl mra me Cuauhtitlan ne ra bktri ra mbot'a ngu bri japi ya tsat'yo bi zi.	ra Tlacatécatl mra me Cuauhtitlan ne ra bktji ra mbot'a ngu bri japi ya tsat'jo bi zi.
ra doy'e̱ pahni xki njom'i ko ya chalchihuite.	ra doj'e̱ pajni xki njom'i ko ya chalchihuite.
ra mu̱di ra Cuauhtémoc, ra hmu ra bondo, ra nyoho ra Tlacotzin, ra Cihuacóatl ra nhñu ra oquiztzin, ra bo̱nahmu ha ra nini ra Azcapotzalco Mexicapan, ra ngoho ra panitzin, ra bo̱nahmu nuni ra Ecatepec,	ra mu̱di ra Cuauhtémoc, ra jmu ra bondo, ra njojo ra Tlacotzin, ra Cihuacóatl ra nhñu ra oquiztzin, ra bo̱najmu ja ra nini ra Azcapotzalco Mexicapan, ra ngojo ra panitzin, ra bo̱najmu nuni ra Ecatepec,
ra mu̱di ra pa mi o̱t'e ra ngo ra mäkime ra u, ra thuhu ra Huixtocihuatl	ra mu̱di ra pa mi o̱t'e ra ngo ra mäkime ra ju, ra tjuhu ra Huixtocihuatl
ra nge'a bi mu̱ni ko ra mahuai ha ra xu̱tha nu'a to'o bi umbabi ra ji.	ra nje'a bi mu̱ni ko ra makjuai ja ra xu̱tha nu'a to'o bi umbabi ra ji.
ra nyoho, bi tho ra ndä ra Nauhtla, mra thuhu ra Cohualpopocatzin.	ra njojo, bi tjo ra ndä ra Nauhtla, mra tjuju ra Kojualpopocatzin.
unga ya ngue̱nda te ra ts'omu̱i mi bu̱'i ne mi japi da ntso̱m'i nuya macehualtin, njabu̱ mi thutuabi ya jä'i mi b'u̱i te ma za	unga ya ngue̱nda te ra ts'omu̱i mi bu̱'i ne mi japi da ntjo̱m'i nuya macehualtin, njabu̱ mi thutjabi ya kjä'i mi b'u̱i te ma za
xib'u̱ bri fádi ge nuya he mi ja nuni ra Cuauhchichilco, ha Xaltocan; ge mi pttsi ya ndá.	xib'u̱ bri fádi ge nuja je mi ja nuni ra Cuauhchichilco, ja Xaltocan; ge mi pttsi ya ndá.
xki mbo̱ni nubu̱ ra hyodi ra Cuehuecatitlan,	xki mbo̱ni nubu̱ ra jodi ra Cuehuecatitlan,
xki thete ra ixtlilxóchitl ne ra ku ra Cohuanacotzin ko ya he dega dänga ndä bi mu̱di da häni ra hoga ts'ofo ya evangelio,	xki thete ra ixtlilxóchitl ne ra ku ra Cohuanacotzin ko ya je dega dänga ndä bi mu̱di da häni ra hoga ts'ofo ja evangelio,
ya dänga ñu̱ni nsafi, ya nsafi, ya mahuai, hangu nu'u̱ gatho xki tagi mbo ha ra hñe.	ya dänga ñu̱ni njafi, ya njafi, ya majuae, jangu nu'u̱ gatjo xki tagi mbo ja ra hñe.
bi o̱tuabi nu'a ra makja xki nk'ohni mra thuhu ra alonso ruiz, ge mi y'o nuni huamuxtitan (Huamuxtitlan) nuni ra hyodi guerrero.	bi o̱tjuabi nu'a ra makja xki nk'ohni mra tjuhu ra alonso ruiz, ge mi y'o nuni huamuxtitan (Huamuxtitlan) nuni ra hjodi guerrero.
di pädi xahño nuna b'e̱fi nehe yoho to'o di pädi da mpe̱fi da y'este nuya hoga do mahye̱gi ya xito, mra thuhu ra ambetz'ihuay.	di pädi xajño nuna b'e̱fi neje yojo to'o di pädi da mpe̱fi da y'este nuja hoga do majye̱ki ya xito, mra tjuju ra ambetz'ijujay.
dra thoki ra nto̱de, ra ketzal dra b'e̱ nuni Coyohuacan.	dra tjoki ra nto̱de, ra ketzal dra b'e̱ nuni Coyohuacan.
e mi r'ani dega xui ra Cihuacóatl g'ea mi zoni ne mı mafi.	e mi r'ani dega xui ra Cihuacóatl g'ea mi zoni ne mı maji.
ebu̱ bi gäi habu̱ mi to̱ge ebu̱ bi yopa ma ha ra hnini ra Cuetaxtlan,	ebu̱ bi käi habu̱ mi to̱ke ebu̱ bi jopa ma ja ra jnini ra Cuetaxtlan,
ge'a ra mu̱di ra thuhu ra Hernando, ra nge'a njabu̱ mra thuhu ra takjä ra Cortés nehe njabu̱ mra thuhu ra ndä católico ne ra ku ra Cohuanacotzin bi thutuabi ra pedro po ra Pedro Alvarado ra nge'a ra takjä,	ge'a ra mu̱di ra tjuju ra Hernando, ra nge'a njabu̱ mra tjuju ra takjä ra Cortés neje njabu̱ mra tjuju ra ndä católico ne ra ku ra Cohuanacotzin bi tjutjuabi ra pedro po ra Pedro Alvarado ra nge'a ra takjä,
ma n'a mi b'ai nuni teotletso, habu̱ ra ñ'u̱ pa manjuäntho pa da zo̱ni nuni ra peñón (Tepetzinco).	ma n'a mi b'ai nuni teotletso, haju̱ ra ñ'u̱ pa manjuäntho pa da zo̱ni nuni ra peñón (Tepetzinco).
"mi tso̱ho̱ getbu̱ ra fu̱nga t'o̱ho̱, habu̱ mi thutuabi ""tajón ra nxu̱ni, njabu̱ bi hutuabi ya ndeznä ya b'e̱hnanoya bi pe̱hni ra ts'e̱y'e̱hmu, mi gu̱t'a ra ñ'u ra Tzihuacpopocatzin, bi bo̱nga ha ra ñ'u."	"mi tso̱jo̱ getbu̱ ra fu̱nga t'o̱jo̱, habu̱ mi tjutuakji ""tajón ra nxu̱ni, njabu̱ bi jutuakji ya ndeznä ya b'e̱jnanoya bi pe̱hni ra ts'e̱j'e̱hmu, mi gu̱t'a ra ñ'u ra Tzihuacpopocatzin, bi bo̱nja ja ra ñ'u."
mra ku ra Cacamatzin mra bo̱nahmu nuni Tetzcoco mri ñ'oui va jä'i mi y'o mpaha.	mra ku ra Cacamatzin mra bo̱najmu nuni Tetzcoco mri ñ'oui va kjä'i mi y'o mpaha.
n'a ra nto̱de dega chalchihuite, xi m'et'e dega ze̱ka do, nehe mi pe̱tsi n'a ra tsant'i de ga k'astaboja.	n'a ra nto̱de dega chalchihuite, xi m'et'e dega ze̱ka do, neje mi pe̱tji n'a ra tsant'i de ga k'astabokja.
ne ndunthi ya ambetz'ihuay ne mar'a hoga do mi pe̱tsi ra mu'ui:	je ndunthi ya ambetz'ijujay ne mar'a hoga do mi pe̱tsi ra mu'ui:
nehe n'a ya the̱sthi dega mboťahuaido.	neje n'a ya the̱stji dega mbotjauaido.
nuna bi o̱t'a ra ntso̱m'i ra nge'a nehe nuya ya b'e̱datsi bi tsini ko ra Cortés ne ra Cohuanacotzin ne ra ixtlilxóchitl xki nsofo pa ra ixtlilxóchitl da gu̱ka ya jä'i ge mi zu ya hyodi, njabu̱ mi pe̱hna ajuä da t'o̱t'e.	nuna bi o̱t'a ra ntso̱m'i ra nje'a neje nuya ya b'e̱jatsi bi tsini ko ra Cortés ne ra Cohuanacotzin ne ra ixtlilxóchitl xki njofu pa ra ixtlilxóchitl da gu̱ka ya kjä'i ge mi zu ja hyodi, njabu̱ mi pe̱jna akjuä da t'o̱t'e.
nuna nt'o̱t'e bi nthandi xa nts'ogi njabu̱ bri thutuabi, bi ena ge mra nzu̱te ko ma m'u̱hai ra nzu̱te ne mi thutsuabi ko ya mpe̱bi dega mabagì, habu̱ hmä ge n'a di ge'u̱ bi y'e̱nga n'a ra do, ko nge'a bi hyo, nu'u̱ mar'a ya b'e̱go ge mä ge nu'u̱ se̱he̱ ya ñämfo̱ bi hyo bi mu̱tu'a n'a ra mahuai ha ri ngati bi mu̱tuabi n'a ra nzu̱ni.	nuna nt'o̱t'e bi njandi xa nts'oji njabu̱ bri tjutuakji, bi ena ge mra nzu̱te ko ma m'u̱jai ra nzu̱te ne mi tjutsuakji ko ya mpe̱bi dega mabagì, habu̱ hmä ge n'a di ge'u̱ bi y'e̱nga n'a ra do, ko nge'a bi hyo, nu'u̱ mar'a ya b'e̱go ge mä ge nu'u̱ se̱he̱ ya ñämfo̱ bi hyo bi mu̱tu'a n'a ra mahuai ja ri ngaji bi mu̱tuakji n'a ra nzu̱ni.
ra Cuauhtémoc, Tlacotzin, ra Cihuacóatl, Oquiztzin, Panitzin, Motelhuihtzin; nuna bi sofo ra Cortés nuni Coyoacan, nu'u̱ to'o mi pädi yoho ya hñäki ngu'a ra jerónimo aguilar ra malintzin.	ra Cuauhtémoc, Tlacotzin, ra Cihuacóatl, Oquiztzin, Panitzin, Moteljuihtzin; nuna bi sofo ra Cortés nuni Coyoacan, nu'u̱ to'o mi pädi jojo ya hñäki ngu'a ra jerónimo aguilar ra malintzin.
t'ena ge ya macehual [ya jä'i b'u̱i ha ra hyoya]	t'ena ge ya macehual [ya kjä'i b'u̱i ja ra jyoja]
"xki thokuabi nuya hotho ts'ints'u̱ mra thuhu ra ""tlauhquecho"" ne “tzinitzcan zacuan"","	"xki tjokuabi nuya jotho ts'ints'u̱ mra tjuju ra ""tlauhquecho"" ne “tzinitzcan zakjuan"","
-¿te be'a gi mä nu'i Cihuacóatl?	-¿te be'a gi mä nu'i Kjiuacóatl?
bi k'ahni ko ya dänga ñuni nzafi ne bi thetse ko ya makahuai nuya otomi geb'u̱ bi japi bi b'e̱di, bi mä nuyu̱:	bi k'ahni ko ya dänga ñuni njafi ne bi thetse ko ya makajuai nuja otomi gekju̱ bi japi bi b'e̱di, bi mä nuju̱:
da thuts'i ya njot'ihñä ( )	da tjuts'i ya njot'ijñä ( )
da umbabihe te da zi, da japabihe ndunthi ma zu.	da umkjabije te da zi, da jakjabije nduntji ma zu.
ebu̱ bi mä nuna b'e̱fi xa thoki xahño bi johya ra ts'e̱y'e̱hmu.	ebu̱ bi mä njuna b'e̱fi xa tjoki xajño bi kjoja ra ts'e̱y'e̱hmu.
"fernando alva ixtlilxóchitl, xiii njändahmä ""ra ñ'ehe ya ñämfo̱ ne ra mu̱di ra hoga ts'ofo ra evangelio."""	"fernando alva ixtlilxóchitl, xiii njändajmä ""ra ñ'eje ya ñämfo̱ ne ra mu̱di ra joga ts'ofo ra evangelio."""
ga juatihu̱ nu'a huts'i njani, ya ts'ojä'i, ra carranza, ge xa o̱t'a ya ts'okuate pa gekagihu̱; ga o̱t'e da nja ra ts'e̱di ma munts' ne njabu̱ ga tsu̱dihu̱ da nja nu'a ra hoga tsu̱tui, da nja ra hai, ra hñegi ne ra hoga ts'u̱tui;	ga kjuatiju̱ nu'a huts'i jnani, ya ts'ojä'i, ra karranza, ge xa o̱t'a ya ts'okjuate pa gekajiju̱; ga o̱t'e da nja ra ts'e̱di ma munts' ne njabu̱ ga tsu̱diju̱ da nja nu'a ra hoka tsu̱tui, da nja ra hai, ra hñegi ne ra hoka ts'u̱tui;
gatho ya hyoyajä'i mi b'u̱i ha ra hnini bi handi.	gatho ya hyoyakjä'i mi b'u̱i ja ra jnini bi jandi.
ha bi häni ra ñ'udi, ma jä'ihu̱ bi ent'i gatho mahye̱gi nuya nzu̱te	ja bi kjäni ra ñ'udi, ma kjä'iju̱ bi ent'i gatjo majye̱ki nuja nzu̱te
ha n'aa nza̱tho xudi ra pale berto, bi bo̱ni nda hyonga te nda nzimxidi ngetho nda zi ya hme hyaxtho mi u̱xa ya u, ua ngu mi nzäi mi nkahui yá hme nuya chuju̱ xa hogi ha nuya 'bomuha̱i nts'ät'i, nt'o̱kuä;	ja n'aa nza̱tjo xudi ra pale berto, bi bo̱ni nda hjonga te nda nzimxidi ngetjo nda zi ya hme hjaxtho mi u̱xa ya u, ua ngu mi nzäi mi nkajui yá hme nuja chujtjo xa jogi ja nuja 'bomuhäi nts'ät'i, nt'o̱kuä;
ha nubia di ndäki, di ndändiñähmu, di ma ga ts'u̱tsa'i ri y'e, ga ndäne'i ra nge'a nu'a'i ma makjahe, ra bartolomé lópez, nub'u̱ mi njuäni ma b'e̱hña inbi njuäni ha nubu̱ mi xaxi pa da o̱t'a ya tso̱mfen	ja nubia di ndäki, di ndändiñähmu, di ma ga ts'u̱tja'i ri y'e, ga ndäne'i ra nje'a nu'a'i ma makjahe, ra bartolomé lópez, nub'u̱ mi nkjuäni ma b'e̱jña inbi nkjuäni ja nubu̱ mi xaxi pa da o̱t'a ya tjo̱mfen
ha ya t'u̱ka ze̱ki thuts'i n'a tu̱kitho nuna thogi ge bi huxa ra fernando alva ixtlilxóchitl, nu'a b'e̱tsi ra xiiii njondahmä.	ja ya t'u̱ka ze̱ki tjuts'i n'a tu̱kitjo nuna tjogi ge bi kjuja ra fernando alva ixtlilxóchitl, nu'a b'e̱tsi ra xiiii njondahmä.
habu̱ ga ju̱he nuyu̱ (ya tenochcas) te gi honihu̱?	ja bu̱ ga ju̱je nuyu̱ (ya tenochcas) te gi joniju̱?
ham'u̱ gatho ya juän'ahmä ge nuua xa ze̱ti ri ñ'ehe dige'a ya noya ya mu̱dimehai ha ra hñä ya ndeznä, nuna thuhu ri uni inga se̱he̱ ra n'atsanoya pa da fädi ra hñämfo̱, ingi ri me̱udi dige'a ra hmä fu̱oti dige'a nuna ra hñäki ra netzahualcoyotl. ne ra cuauhtémoc.	jam'u̱ gatjo ya juän'ahmä ge nuua xa je̱ti ri ñ'eje dike'a ya noya ya mu̱dimehai ja ra hñä ya ndeznä, nuna tjuhu ri uni inga se̱je̱ ra n'atsanoya pa da fädi ra hñämfo̱, ingi ri me̱udi dike'a ra hmä fu̱oti dike'a nuna ra hñäki ra netzahualcoyotl. ne ra cuauhtémoc.
mi hneki ngu ma jä'ihu̱ ngabu̱ mri hneki.	mi hneki ngu ma kjä'iju̱ ngabu̱ mri hneki.
ndunthi bri johya, bri thuxpabi gatho nu'a mi o̱t'abi ra b'edi, ko nge'u̱ bi m'u̱i ne mi t'umbabi ya t'ixu:	ndunthi bri kjojya, bri tjuxpabi gatho nu'a mi o̱t'abi ra b'edi, ko nge'u̱ bi m'u̱i ne mi t'umbabi ja t'ixu:
ngu mra me̱ti, nu'a r'a hyodi, habu mi y'o, n'a ngu n'a mi johya mi mfe̱m'a xinxi xi mi johya ya ndäte, mi thede n'a ngu n'a mi hñu̱fi ne mi fe̱m'a ya xinxi: xi mi b'u̱i mpaha.	ngu mra me̱ti, nu'a r'a kjodi, habu mi y'o, n'a ngu n'a mi kjoja mi mfe̱m'a xinxi xi mi kjoja ya ndäte, mi thede n'a ngu n'a mi hñu̱fi ne mi fe̱m'a ya xinxi: xi mi b'u̱i mpaha.
njabu̱ ri ñ'ehe ya je̱ya inda m'e̱di, inda mpumfri, ga nzäi ga pe̱tsi nugagihu̱ ha ma mfenihu̱, ga pe̱tsi nugagihu̱, ra bätsi dige'u̱, ya b'e̱to, ya ntsaniku, ya mbänga b'e̱to ne to'o dra ñ'epu̱, to'o mahye̱gigihu̱, ma jihu̱, ya ku̱hu̱.	njabu̱ ri ñ'eje ya je̱ja inda m'e̱di, inda mpumfri, ga nzäi ga pe̱tsi nugajihu̱ ja ma mfeniju̱, ga pe̱tsi nugajihu̱, ra bätsi dike'u̱, ya b'e̱to, ya ntsaniku, ya mbänga b'e̱to ne to'o dra ñ'epu̱, to'o majje̱gigiju̱, ma jiju̱, ya ku̱ju̱.
nu xä oth'u̱, ma gä ñ'jähu̱	nu xä otj'u̱, ma kä ñ'kjahu̱
nuga̱ xi di ne'i, hindi pädi hanja...	nuga̱ xi di ne'i, jindi pädi hanja...
num'u̱ di johyahu̱, nkuehu̱, nts'o̱mihu̱, tsuhu ne pa da t'o̱xkähu̱ di hohñu̱ nu ya nt'u̱i xi di 'yoohu̱ (¡!). nuya da nt'ot'i ko ra dänt'ot'í	num'u̱ di kjojyaju̱, nkueju̱, nts'o̱miju̱, tsuju ne pa da t'o̱xkjaju̱ di jojñu̱ nu ya nt'u̱i xi di 'jooju̱ (¡!). nuja da nt'ot'i ko ra dänt'ot'í
nuna bi johya ha ra mabagi,	nuna bi kjohya ja ra mabaki,
nuya hñu o gohoya pa bi b'u̱i nubu̱ bi xitsuabi ra jäpadehe ndunthi ya jä'i, ngu xa t'ena.	nuya hñu o gohoja pa bi b'u̱i nubu̱ bi xitjoabi ra kjäpadeje ndunthi ya kjä'i, ngu xa t'ena.
nuya tsat'io mi b'et'o, mi gu̱t'a ra ñ'u, mi teni, ya xiñu mi ju̱ts'i pa mañä, xi mi pähä gatho mi handi mi nest'ihi: mi tu̱ta ya jihni	nuya tsat'io mi b'et'o, mi gu̱t'a ra ñ'u, mi teni, ya xiñu mi ju̱ts'i pa mañä, xi mi pähä gatjo mi jandi mi nest'ihi: mi tu̱ta ya kjihni
pe, nu'i ndada nu'i ma t'ek'ei ra makja, nub'u̱ nu'i ingi zugagihe, ¿hanja, nuua, ra hyo di ge'a, ga tsogi nubu̱ [nu'a ma b'e̱hña]?	pe, nu'i ndada nu'i ma t'ek'ei ra makja, nub'u̱ nu'i ingi zukagihe, ¿jakja, nuua, ra hyo di ge'a, ga tjogi nubu̱ [nu'a ma b'e̱jña]?
r'a ya jä'i mi b'u̱i ha ra ngumi ja nunu ha ra hnini ri manjuäntho pa da tsoni nubu̱ ra amáxac,	r'a ya kjä'i mi b'u̱i ja ra ngumi ja nunu ja ra jnini ri manjwäntho pa da tsoni nubu̱ ra amáxak,
ra nge'a di o̱t'a nuna noya ra ts'u̱tui ne gatho to'o da guat'a ha ma hyohe, nu'u̱ to'o da ne, da me̱tsi n'a ra hoga m'u̱i ne da m'u̱i manjuänthä. ha nubu̱ xa mabu̱ ma noya ge di pe̱tsi ra tsa, dega hoga jä'i ne dega hogat'o̱t'antuhni	ra nge'a di o̱t'a nuna noya ra ts'u̱tui ne gatjo to'o da guat'a ja ma hjoje, nu'u̱ to'o da ne, da me̱tsi n'a ra hoga m'u̱i ne da m'u̱i manjwänthä. ja nubu̱ xa mabu̱ ma noya ge di pe̱tsi ra tsa, dega hoga kjä'i ne dega hogat'o̱t'antuhni
ra ngehna nuna pa bi ma n'a ra ñ'u manjuäntho.	ra ngejna nuna pa bi ma n'a ra ñ'u manjwäntho.
ra nhñu ne ra ngästsi ra b'ist'ofo di huts'ihu̱ ha nuna ze̱ki b'ist'ofo, ri ñ'ehe ra vii njondahmä ra chimalpain,	ra ñhñu ne ra ngästsi ra b'ist'ofo di huts'iju̱ ja nuna ze̱ki b'ist'ofo, ri ñ'eje ra vii njondakmä ra chimalpain,
ra nthädi ra cuitlahuacatzin bi ena ge ina da o̱t'e nuya bi b'e̱pabi ya nso̱ho̱jä'i,	ra njädi ra cuitlahuacatzin bi ena ge ina da o̱t'e nuya bi b'e̱pabi ya njso̱jo̱kä'i,
ra nyoho nu'a mi zu ra tepoztlan; ra nhñu ra me tizatlan, ra njoho mi ñ'ehe nuni huehuetlan ne ra nku̱ta mra dänga mictlan.	ra njojo nu'a mi zu ra tepoztlan; ra nhñu ra me tizatlan, ra njojo mi ñ'eje nuni huehuetlan ne ra nku̱ta mra dänga mictlan.
ri ñ'udi xahño nubia hanja beni ya metlaxcala bi do̱m'i mpaha nuya nso̱ho̱ jä'i.	ri ñ'udi xajño nubia hanja beni ya metlaxcala bi do̱m'i mpaha nuya nso̱jo̱ kjä'i.
t'ena ge inbi unga mfädi pa gatho ya jä'i mi ñ'oui, ge nuna ndada ra marqués da ñ'ehe dra hmu ha ma haihe, da ja me̱ti nu'a di pe̱tsihe nehe dra jakagihe ga mpe̱fihe ra hai ge bi umbabi o bi hänbabi ya hoga hai ya n'añ'o hnini.	t'ena ge inbi unga mfädi pa gatjo ya kjä'i mi ñ'oui, ge nuna ndada ra marqués da ñ'eje dra hmu ja ma jaihe, da ja me̱ti nu'a di pe̱tsihe neje dra jakagihe ga mpe̱fihe ra jai ge bi umbabi o bi kjänbabi ya hoga jai ya n'añ'o jnini.
xi mi taxki ra ñ'u, imbi tsa da r'anga n'a, ho̱nse̱he̱ mi taxka n'a ha ra bo̱hai. ya y'ofadi mi ju̱t'atho.	xi mi taxki ra ñ'u, imbi tsa da r'anja n'a, jo̱nse̱je̱ mi taxka n'a ja ra bo̱jai. ya y'ofadi mi ju̱t'atjo.
ya dänga mfu̱nga bo̱jä bi ntho, bi kot'i ko ya mahjuai, mi zu̱m'i nehe ko ya t'e̱nga ts'u̱t'abo̱ja.	ya dänga mfu̱nga bo̱kja bi ntho, bi kot'i ko ya majjuai, mi zu̱m'i neje ko ya t'e̱nga ts'u̱t'abokja.
ya r'atsanoya ra sahagún mi mä hanja mi yopa tsini. ya ndeznä bi nkohi inda ñ'udi. mi hatatho pa bi mu̱di ra ntuhni	ya r'atsanoya ra sahagún mi mä janja mi yopa tsini. ja ndeznä bi nkoji inda ñ'udi. mi jatatho pa bi mu̱di ra ntuhni
ya zi b'e̱hña mi ägi ha ya b'a ne ha ya ngo̱de, nuya ñ'o̱ho̱ mbo ha ya ne, ha ya njom'ahudi.	ya zi b'e̱jña mi ägi ja ya b'a ne ja ya ngo̱de, nuya ñ'o̱jo̱ mbo ja ya ne, ja ya njom'ahudi.
bi boxro xi 'be̱ts'ina, bido'u̱ ro 'yu̱ni 'na, xi bi bo̱x ro hjua 'na, bido'u̱ ro ts'ii 'na, xi bo̱xro ts'äre 'na. ge'bu̱ go min pu̱n doja 'na.	bi bokjro xi 'be̱ts'ina, bido'u̱ ro 'ju̱ni 'na, xi bi bo̱x ro kjua 'na, bido'u̱ ro ts'ii 'na, xi bo̱xro ts'äre 'na. ge'bu̱ go min pu̱n doja 'na.
bi ma manjuäntho habu̱ mi b'u̱i ra ts'e̱y'e̱hmu bi xipabi;	bi ma manjwäntho habu̱ mi b'u̱i ra ts'e̱j'e̱hmu bi kjipabi;
bri juahni po nuya dra hmu.	bri kjuajni po nuya dra jmu.
di to̱m'ihe ra ñ'ethi pa nugagihe, n'a ra pa ngu ma n'a ra pa thogi nekagihe di huadihe ra nge'a indi tse̱tihe nuna b'u̱i t'o̱t'e ko ngekagihe man'año ya ntho, t'e̱nts'igihe thi ma haihe ma me̱tihe, ju̱kagihe ga mpe̱fihe ndunthi, b'e̱kagihe ga jut'ihe xdunthi ya boja, n'a ngu n'a ra pa nuna njut'i di o̱t'ehe man'a te ma thaihe di tuhe.	di to̱m'ihe ra ñ'ethi pa nugajihe, n'a ra pa ngu ma n'a ra pa tjogi nekajihe di huajihe ra nge'a indi tse̱tjihe nuna b'u̱i t'o̱t'e ko ngekajihe man'año ya ntho, t'e̱nts'ijihe tji ma jaihe ma me̱tjihe, ju̱kajihe ga mpe̱fjihe ndunthi, b'e̱kajihe ga jut'ihe xdunthi ya bokja, n'a ngu n'a ra pa nuna njut'i di o̱t'eje man'a te ma tjaihe di tuhe.
gatho nuna hai ha nuna r'ayo ximhai njabu̱ bi thutuabi nuya nso̱ho̱jä'i inbi tsa bi thutuabi man'a ra thuhu.	gatho nuna hai ja nuna r'ayo ximjai njabu̱ bi tjutuabi nuya nso̱jo̱kä'i inbi tsa bi tjutuabi man'a ra tjuju.
ha mi tso nde, bi mu̱di bi nja n'a ra hneki ngu njagihu̱ dega jä'i, bi t'ot'e ra b'ai ngu dega jä'i,	ja mi tso nde, bi mu̱di bi nja n'a ra jneki ngu njajiju̱ dega kjä'i, bi t'ot'e ra b'ai ngu dega kjä'i,
ma bo̱nahmu'ihe: nuna b'e̱fi ga tsokagihe sta juatihe gatho: gi nuti nuua, xa hño bo̱nahmu.	ma bo̱najmu'ihe: nuna b'e̱fi ga tsokajihe sta kjuatihe gatjo: gi nuti nuua, xa hño bo̱najmu.
mi mä dega ts'e̱dira hñä tso̱pu da ts'o̱ho̱bu nuya nzo̱ho̱jä'i ga handihu̱ te ma ts'e̱di pe̱tsi, ra nge'a ma ajuä ra quetzalcohuatl b'u̱i nuua ko ngekagihu̱,	mi mä dega ts'e̱dira hñä tjo̱pu da ts'o̱jo̱bu nuya nzo̱jo̱kjä'i ga jandiju̱ te ma ts'e̱di pe̱tsi, ra nge'a ma akjuä ra quetzalcohuatl b'u̱i nuua ko ngekajiju̱,
ne ya nt'u̱i, hanja di thuts'i ya nt'ofo, njap'u̱ nehe mä 'ra ya mpeu̱i da fats'i di nt'ot'i ra hñähñu	ne ya nt'u̱i, hanja di tjuts'i ya nt'ofo, njap'u̱ neje mä 'ra ya mpeu̱i da fats'i di nt'ot'i ra hñähñu
nub'u̱ nu'i ingi japi da bo̱nga nu'a ra makja ha nu'a ra hnini, ¿hanja ra yotui, ga tso̱gi nubu̱ ma b'e̱hña? o̱t'a r'ato ya je̱ya bi mu̱di [ra makja ra bartolomé lópez]	nub'u̱ nu'i ingi kjapi da bo̱nga nu'a ra makja ja nu'a ra jnini, ¿kanja ra yotui, ga tso̱ki nubu̱ ma b'e̱jña? o̱t'a r'ato ya je̱ya bi mu̱di [ra makja ra bartolomé lópez]
pa ga b'u̱i mpaha ne ga o̱t'e n'a ra njondahmä gatho nu'a ga handi.	pa ga b'u̱i mpaha ne ga o̱t'e n'a ra njondakmä gatjo nu'a ga jandi.
r'a nuna mi nthandi ngu nu'a ma thänjuahu̱ (ychtlilmatli), xi mra nts'o, mi kuet'e ha ya ngo̱,	r'a njuna mi njandi ngu nu'a ma tjänjuaju̱ (ychtlilmatli), xi mra nts'o, mi kuet'e ja ya ngo̱,
xa zägi mpaha, nub'u̱ xa njabu̱ xa japabi ma zu ne inte xa t'o̱tuabi nub'u̱ inda japi xa po̱ho̱ bi ya kue̱ ra nge'a ya jä'i xi mra no̱t'e ne mra hyotejä'i,	xa zägi mpaha, nub'u̱ xa njabu̱ xa jakpabi ma zu ne inte xa t'o̱tjuabi nub'u̱ inda japi xa po̱jo̱ bi ya kue̱ ra nge'a ya kjä'i xi mra no̱t'e ne mra hjotejä'i,
y'o, ri ma ne gi xipabihu̱ ya metlaxcala ge ma r'a ya me̱ti jä'i ne ri ajuähu̱, ge nu'a ga mä ge xa ehe nuua ma haihu̱, ge di umbabihe ma nthädihe.	y'o, ri ma ne gi xipabiju̱ ya metlaxcala ge ma r'a ya me̱ti kjä'i ne ri ajuäju̱, ge nu'a ga mä ge xa ehe nuua ma haiju̱, ge di umbabihe ma njädihe.
¿te da o̱t'e ma jä'ihu̱ sta b'e̱dihu̱?	¿te da o̱t'e ma kjä'iju̱ sta b'e̱diju̱?
-da ts'iua:... ri ñ'ehe ge'a ma njueih'u̱. da o̱t'ehe ya ñ'o̱te ko ya he̱m'i, ya ñ'o̱t'ehe ko ya ntuts'i. da o̱ts'e̱ ra b'e̱na noya.	-da ts'iua:... ri ñ'eje ge'a ma njueij'u̱. da o̱t'eje ya ñ'o̱tje ko ya je̱m'i, ya ñ'o̱t'eje ko ya ntuts'i. da o̱ts'e̱ ra b'e̱na noya.
-dom'i ma ajuähu̱ ge inda yu̱t'a ha ma nguhu̱ nuhu̱ to'o e̱nts'i pa thi ne da hokuabi ra honanhyo nub'u̱ sta ne da hyoki ya inda za.	-dom'i ma akjuäju̱ je inda yu̱t'a ja ma nguju̱ nuju̱ to'o e̱nts'i pa tji ne da hokuabi ra jonanjyo nub'u̱ sta ne da joki ya inda za.
-o̱t'a ra mäte gi o̱dehu̱, ja gi b'ai nuuahu̱. mont'a ya ngo ajuä; ri juat'i ra ngo ga tsunda ma ajuähe.	-o̱t'a ra mäte gi o̱deju̱, ja gi b'ai nuuaju̱. mont'a ya ngo akjuä; ri kjuat'i ra ngo ga tsunda ma akjuähe.
-xa hño, di b'u̱ihe njamädihe.	-ja hño, di b'u̱ije njamädihe.
-¿nguande njabu̱ ga mäu gra juähu̱?	-¿nguande njabu̱ ga mäu gra kjuäju̱?
-ñ'emabagi, ya gabida, ya jä'ihu̱ gi pädi ra ntuni ra mem'onda ba ehehu̱ ga te̱nihu̱ma nzu̱tehu̱. ko ya mätsa mi te̱he̱, ko ya bu̱'bai ko ngatho ra ts'e̱di mi te̱he̱ ra ñ'u.	-ñ'emabaki, ya kabida, ya kjä'iju̱ gi pädi ra ntuni ra mem'onda ba ejeju̱ ga te̱nihu̱ma nzu̱teju̱. ko ya mätsa mi te̱je̱, ko ya bu̱'bai ko ngatjo ra ts'e̱di mi te̱je̱ ra ñ'u.
bi tse̱ti nuna ngot'i ra m'onda, ngu pede ra dänga b'ede, ya k'oi ne ya njändahmä, ngu nu'a ra hmä ra alonso axayaca, goho n'ate ma pa bi nzo̱t'e nuna pa.	bi tse̱ti nuna ngot'i ra m'onda, ngu peje ra dänga b'ede, ya k'oi ne ya njändahmä, ngu nu'a ra hmä ra alonso axayaca, gojo n'ate ma pa bi nzot'e nuna pa.
into y'o manjuäntho, into pa ri nektho.	into y'o manjwäntho, into pa ri nektjo.
nub'u̱ ndi umbabihe ma njut'ihe xki nzäi ndi da'ihe, mi adi n'a tu̱ki nehe nub'u̱ ndi unihe ya k'astaboja mi häni made n'a tu̱ki [...]	ja nubu̱ ndi umbabihe ma njut'ihe xki nzäi ndi da'ihe, mi adi n'a tu̱ki neje nubu̱ ndi unije ya k'astabokja mi häni made n'a tu̱ki [...]
ya miñ'o ko ngehna hmä ri johya,	ya miñ'o ko ngejna hmä ri kjoja,
bi tso̱hso̱ ra ngo ma ajuähu̱: nubia da fu̱di da guadi ra r'e̱t'a ra pa.	bi tso̱jso̱ ra ngo ma akjuäju̱: nubia da fu̱di da guadi ra r'e̱t'a ra pa.
