INALI	OTS
"-pasadores: ""ya nts'äza xi mra nts'u̱t'i mi t'e̱ni ko n'a ra t'e̱nga ts'u̱t'a bo̱ja mi thutuabi ra ballesta""."	ya ntza xa mra ntstu̱ti mi teni ko na ra tnga tsu̱ta bo̱xa mi tutuabi ra ballesta
cantares mexicanos, biblioteca nacional de méxico, ya nt'ofo 1628 bis, folio 16 v.	cantares mexicanos, biblioteca nacional de méxico, ya nd'ofo 1628 bis, folio 16 v.
"ebu̱ bi bo̱ni, bi meui nuni nonohualco, ha ra ngu ra b'ongui habu̱ ra gabida ne ra malintzin ne ""ra hyadi"" (alvarado) ne ra sandoval."	"ebu̱ bi bo̱ni, bi meui nuni nonohualco, ha ra ngu ra b'ongui habu̱ ra gabida ne ra malintzin ne ""ra hyadi"" (alvarado) ne ra sandoval"
gi handi ra nt'ofo ra thuhu ra crónicas de la conquista	gi jandi ra nd'ofo ra tuhu ra crónicas de la conquista
guzmán. ha ya he̱m'i b'e̱tsa je̱ya manteb'u̱ di ge nuua m'onda ne ya hyo, nu'a ra hmä ra 12-conejo (1530) ge xa hmä ge xibú bi yut'i ha ra culhuacan ya ndeznä, nda pablo xochiquetzin, motelchiuhtzin ne ra guzman.	Guzmán. Ha ya hem'i be̱tsa je̱ya mante̱b'u di ge nuua m'onda ne ya hyo, nu'a ra hmä ra 12-conejo (1530) ge xa hmä ge xibú bi yut'i ha ra Culhuacan ya ndeznä, nda Pablo Xochiquetzin, Motelchiuhtzin ne ra Guzman.
ha ga ñ'udihu̱ ra nt'ofo ya ñämfo̱ po ra nthuts'i ra doctor garibay,	ha ga ŋ'udihu ra nt'oho ya ŋämfo po ra nthuts'i ra doctor garibay,
ha nu'a hyodi nubia thutuabi ra san martin.	ha nua hyodi nubia thutuabi ra san martin
he̱mi unga mfädi ha ra t'u̱ka hnini habu̱ b'u̱i ya jä'i teni ra división ra arenas, 27 ra abril ra je̱ya 1918, ra m'ets'a he̱m'i ra zapata, b'e̱tsi ha ra universidad nacional autónoma de méxico, expediente 29.	he̱mi unga mfädi ha ra t'uka hnini habu̱ b'u̱i ya jä'i teni ra división ra arenas, 27 ra abril ra je̱ya 1918, ra m'ets'a he̱m'i ra zapata, b'etsi ha ra universidad nacional autónoma de méxico, expediente 29.
"m'e̱fa ha ra hñuti bri thätuabi na ra hñe xki tagiri mo̱te, nehe bri jom'a ra xu̱tha ko n'a ra t'axa dutu mra thuhuu ra ""campanillante""."	"m'efa ha ra hñuti bri thätuabi na ra hñe xki tagiri mo̱te, nehe bri jom'a ra xu̱tha ko n'a ra t'axa dutu mra thuhuu ra ""campanillante"""
ma dada'ihe gra ts'u̱tui, di ne gi pädi ge ma me̱t'o instä thogihe nuna thogi gatho ya mapa xki r'ani, bi juat'i ko ngeke nu̱'u ri b'e̱go, ri me̱fi ya ñämfo̱, ra nge'a majuäni ra hernando cortés ra ndä gabida,	ma dada'ihe gra ts'utui, di ne gi pädi ge ma met'o insta thogihe nuna thogi gatho ya mapa xki r'ani, bi juati ko ngeke nu'u ri b'ego, ri mefi ya ñamfo, ra nge'a majuani ra hernando cortés ra nda gabida,
mi b'u̱i ya mu̱dimehai mi ñä ra ndeznä ne habu̱ ra hnini dige'a gatho ra nxiki m'onda ngu r'a ya yaqui b'u̱i nuni sonora ne ya maya ri ñ'ehe nuni yucatán ra nge bi guat'i ha ra tuhni bi nja nuua m'onda fädi ko ra thuhu ra revolución mexicana ya je̱ya 1910-1919.	mi bʼui ya mudimejai mi ñä ra ndeznä ne habʼu ra hniini digeʼa gatho ra nxiki mʼonda ngu rʼa ya yaqui bʼui nuni sonora ne ya maya ri ñʼehe nuni yucatán ra nge bi guatʼi ha ra tuhni bi nja nuua mʼonda fädi ko ra thuhu ra revolución mexicana ya jeʼya 1910-1919.
mi fo̱tuabi ya ts'u̱tnibo̱ja mi thutuabi ya hñämfo̱ ra pasadores nehe ya bo̱zna ko ya nzafi.	mi fōtūābi ya ts'ūtṇībōja mi thūtūābi ya ñǣmfō ra pasadores nehe ya bōzna ko ya nzāfī
n'a nt'udi di ge'a nuya nthoki bri t'o̱t'e ha ya hñä ya ndeznä ra ngätsi ra nthebe nje̱ya ra r'e̱t'a ma gu̱to (s. xix), r'a ya hnini ngu ra xicontepec (villa juárez) nuna hyodi kohi nuni puebla.	n'a nt'üdi di ge'a nüya nt'oki bri t'öt'e ha ya hñä ya ndeznä ra ngätsi ra nthebe nje̱ya ra r'et'a ma gu̱to (s. xix), r'a ya hnini ngu ra xicontepec (villa juárez) nuna hyodi kohi nuni puebla.
"n'a ra t'axa dutu mi pe̱tsi ya k'oi ra ixki, nuna mra thuhu hñämfo̱ ""campaneante resonador""."	"n'a ra t'axa dutu mi pe̱tsi ya k'oi ra ixki, nuna mra thuhu hñä̃mfo̱ ""campaneante resonador"""
ne ri mpe̱fi ha ra dängan gu nt'udi ra thuhu ra facultad de estudios superiores, acatlán, unam,	ne ri mpʉ̱fi ha ra däŋan gu nt'udi ra tʉhu ra facultad de estudios superiores, acatlán, unam,
nthandi gatho nu'a ra munts'i ra thuhu hñämfo̱ ra globalización ge 'a po̱ts'e dega nest'ihi, nuna y'o̱te to̱m'i da nja ra ntho̱mäte.	ndathi gatho nua ra muntshi ra thuhu hñamfo ra globalización ge a po̱tse dega nestihi, nuna yo̱te tomi da nia ra nthomate.
nu'a ma r'a ya jä'i mi pädi nuña b'e̱fi bri b'e̱pabi xa hyoki yoho ya mpe̱fi mi fädi ko ra thuhu ra amosqueador ko ya xi ya ts'ints'u̱ xi sta hotho, gi hutsuabi made dige'a n'a ra zänä dega k'astaboja	nu'a ma r'a ya jä'i mi pädi nuña b'e̱fi bri b'e̱pabi xa hyoki yoho ya mpe̱fi mi fädi ko ra t'uhu ra amosqueador ko ya xi ya ts'ints'u xi sta hoto, gi hutsuabi made dige'a n'a ra zänä dega k'astaboja
"nu'a ra munts'a jä'i bi te̱ni bi zipabi man'a ya b'ede, mi t'ena ge ya jä'i xki b'u̱i nubu̱ inbi pe̱tsi ra ts'e̱di nu'a mi mä pe m'e̱fa bi japi bi nxaxni ya tsu̱tui ne n'a ra diputado mi pe̱tsi ra mfeni xki kot'i mra thuhu ra josé maría lozano, bi y'onga ra hmä pa mar'a ya ñ'oui bi nxanxi: ""ri mo̱te ra thits'i mi udi ra emiliano zapata, nehe bri fädi ngu ra atila nuna bri nju̱tsi [...] nu'a bi fädi ngu mi he̱gi ya b'e̱go ne'a bi mä da uni da nja pa gatho, ingi jot'i [...]"	"nu'a ra munts'a jä'i bi te̱ni bi zipabi man'a ya b'ede, mi t'ena ge ya jä'i xki b'u̱i nubu̱ inbi pe̱tsi ra ts'e̱di nu'a mi mä pe m'e̱fa bi japi bi nxaxni ya tsu̱tui ne n'a ra diputado mi pe̱tsi ra mfeni xki kot'i mra thuhu ra José María Lozano, bi y'onga ra hmä pa mar'a ya ñ'oui bi nxanxi: ""ri mo̱te ra thits'i mi udi ra Emiliano Zapata, nehe bri fädi ngu ra Atila nuna bri nju̱tsi [...] nu'a bi fädi ngu mi he̱gi ya b'e̱go ne'a bi mä da uni da nja pa gatho, ingi jot'i [...]"
nu'u̱ to'o ñä ra ndenzä ha r'e̱t'a ma r'at'o ya estados.	nu'u to'o ñä ra ndežä ha r'et'a ma r'ato ya estados.
nub'u̱ ri m'e̱hni ne ri b'e̱go ya ñämfo̱ bi juat'i ko ngekagihe ne bi tso̱ho̱ ra gabida ra thuhu ra hernán cortés, maske indi pädihe ge gatho da za da o̱t'e ne xi ra nzunda maría trinidad,	nub'u̱ ri me̱hni ne ri be̱go ya ña̱mfo̱ bi juat'i ko ngekagihe ne bi tso̱ho̱ ra gabida ra thuhu ra hernán cortés, maske indi pa̱dihe ge gatho da za da o̱t'e ne xi ra nzunda maría trinidad,
nubia, unga mfädi ha ra ñähñu jamädi ra universidad autónoma del estado de hidalgo.	nubia, unga mfäti ha ra ñäñu jamäti ra universidad autónoma del estado de hidalgo.
nugi, ra miguel hernández ge di pe̱tsi ma ngu nuni chiyauhtzinco, ko ra t'ek'ei di udi ko nge'i, nuna m'e̱hnant'ofo di hoki go tso̱n'i ko nge'i, ma t'ek'ei bo̱nahmu'i nda doctor alonso ruiz, ra nk'ohnate ge gi b'ui nuua ha ra hnini ra quamochtitla.	nugi, ra miguel hernández ge di pe̱tsi ma ngu nuni chiyauhtzinco, ko ra t'ek'ei di udi ko nge'i, nuna m'e̱hnant'ofo di hoki go tso̱n'i ko nge'i, ma t'ek'ei bo̱nahmu'i nda doctor alonso ruiz, ra nk'ohnate ge gi b'ui nuua ha ra hnini ra quamochtitla.
nuna he̱m'i bri t'unga mfädi ko ra t'u̱ka nthint'ant'ofo po ra marcelo díaz salas ne ra luis reyes garcía ha: tialtocan, revista de fuentes para el conocimiento de las culturas indígenas de méxico, vol. vi, 1970, b'ede ra 3, pp. 193-212.	nuna hem'i bri t'unga mfaadi ko ra t'uka nthint'ant'ofo po ra Marcelo Díaz Salas ne ra Luis Reyes García ha: Tialtocan, Revista de Fuentes para el Conocimiento de las Culturas Indígenas de México, Vol. VI, 1970, b'ede ra 3, pp. 193-212.
"nuna hñäpi huts'i ha n'a ra he̱m'i fädi ra derecho canonigo ko ra thuhu hñämfo̱ ngu ra ""solicitación al administrar el sacramento de la confesión""."	"nuna hñäpi huts'i ha n'a ra hem'i fädi ra derecho canonigo ko ra thuhu hñämfo ngu ra ""solicitación al administrar el sacramento de la confesión"""
nuna m'e̱hna nt'ofo b'e̱tsi ha ra archivo histórico nacional, madrid, documento 165. bi unga mfädi ha ra nt'ofo ya zubi po ra y'ofo ra thuhu ra arthur j. o. anderson et al.: byond the codices: the nahua view of colonial mexico, berkeley, university of california press, 1976, pp. 181-187.	nuna m'ehna nt'ofö b'etsi ha ra archivo histórico nacional, madrid, documento 165. bi unga mfädi ha ra nt'ofö ya zubi po ra y'ofö ra thuhu ra arthur j. o. anderson et al.: byond the codices: the nahua view of colonial mexico, berkeley, university of california press, 1976, pp. 181-187.
nuna nt'ofo b'e̱tsi ha ra archivo general de indias, sevilla, audiencia de méxico 168, bi unga dra fädi po ra miguel león-portilla ha cultura en peligro, méxico, alianza editorial mexicana, 1976, pp. 102-103.	nuna nt'oho b'ëtsi ha ra archivo general de indias, sevilla, audiencia de méxico 168, bi unga dra fädi po ra miguel león-portilla ha cultura en peligro, méxico, alianza editorial mexicana, 1976, pp. 102-103.
nuna pika he̱m'i ja te mä b'e̱tsi ha ra archivo general de la nación, nuua m'onda ne ja ha ra ndunthi ya hnini, njabu̱ ngu ya nzaya nuni manhyati ne mar'a ya hnini, o̱t'e gi o̱de ra hñä ra mu̱dimehai.	nuna pika hem'i ja te ma be̱tsi ha ra archivo general de la nación, nuua monda ne ja ha ra ndunthi ya hni̱ni, njabu̱ ngu ya nzaya nuni manhyati ne mar'a ya hni̱ni, o̱te gi o̱de ra hña ra mudimehai.
nuua t'unga yoho ya hmä, kuän'ahmä ya ndeznä ne thuts'i ha n'a ra k'oi mä mäjuäni ri nthe̱ui n'a ya dänga ra thu̱ahmä manteb'u̱, nuua pede nu'a gatho ya ts'othogi bi y'o̱t'a dega fete ra alvarado.	nuua t'unga yoho ya hmä, kuän'ahmä ya ndeznä ne thuts'i ha n'a ra k'oi mä mäjuäni ri nthe̱ui n'a ya dänga ra thu̱ahmä manteb'u̱, nuua pede nu'a gatho ya ts'othogi bi y'o̱t'a dega fete ra alvarado
nuua ya mu̱di noya ra motolinia, ha ra mu̱di nkohi bi t'o̱t'e ko ra thuhu ra tratado tercero ra dänga b´ede ya mu̱dimehai nuua r´ayo manhyati:	nuha ya mɨdi noya ra motolinia, ha ra mɨdi nkohi bi t'ɨt'ɨ ko ra thuhi ra tratado tercero ra dɨnga b'ede ya mɨdimehai nuha r'ayo manhyati
"pa da t'unga mfädi gatho nu'u̱ bi nja, n'a di ge'u̱ ko ngu fe̱ti nu'a majuäni mi hoki mi thutsuabi ya hnei ne ya b'ida. b'u̱i man'a ra mfädi da t'o̱t'a ra nt'udi, nu'a ra thuhu ""fe̱ta nu'a majuäni bi nja nub'u̱ ra tsokat'o̱tamfeni (teatro de la conquista)""."	"pa da t'unga mfädi gatho nu'u bi nja, n'a di ge'u ko ngu fe̱ti nu'a majuäni mi hoki mi thutsuabi ya hnei ne ya b'ida. b'u man'a ra mfädi da t'o̱t'a ra nt'udi, nu'a ra thuhu ""fe̱ta nu'a majuäni bi nja nub'u ra tsokat'o̱tamfeni (teatro de la conquista)""."
ra europa -mra nxika hai manteb'u̱, mi pe̱tsa n'a ra nxika b'ede-	ra europa -mra nxika hai mantehu, mi pehca n'a ra nxika b'ehde-
ra fernando ramírez mä ge nuna hyodi ri nge̱pu̱ habu̱ ja n'a ra nija ra san fernando ne ra ermita dige'a ya mártires dige'a san hipólito,	ra fernando ramírez mä ge nuna hyodi ri nge̱bu̱ habu̱ xa n'a ra nija ra san fernando ne ra ermita dige'a ya mártires dige'a san hipólito,
"ra fernando de alva ixtlilxóchitl, fernando de, xiii relación: ""ra ñ'ehe ya ñämfo̱ ne ra fu̱di ra nkanfri ra evangelio""."	"ra fernando de alva ixtlilxóchitl, fernando de, xiii relación: ""ra ñ'ehe ya ñämpho ne ra füdi ra nkaphri ra evangelio"""
ra kuän'ahma ra n luz jiménez bi huts'i ra fernando horkasitas bi unga mfädi ne bi r'atsi nuña hmä), de porfirio díaz zapata, memoria nábuatl de milpa alta, méxico, unam,, instituto de investigaciones históricas, 1974, p. 105	ra kwäṉ'ahma ra n luz jiménez bi huči ra fernando horkasitas bi uŋa mfädi ne bi r'aci nuña hmä, de porfirio díaz zapata, memoria náhuatl de milpa alta, méxico, unam, instituto de investigaciones históricas, 1974, p. 105
ra raymundo isidro alavez, bi b'u̱i'i nuni ra boxtha chico, san salvador, estado de hidalgo	ra raymundo isidro alavez, bi b'ui'i nuni ra boxtʰa chico, san salvador, estado de hidalgo
ra hmä ra fundación de santo tomás ajusco, archivo general de la nación, méxico, ramo de tierras vol. 2676, expediente. 4, archivo histórico de la biblioteca nacional de antropología, colección antigua, vol. 254, fojas 259 r.- 260 v.	ra hmä ra fundación de santo tomás ajusco, archivo general de la nación, méxico, ramo de tierras vol. 2676, expediente 4, archivo histórico de la biblioteca nacional de antropología, colección antigua, vol. 254, fojas 259 r.- 260 v.
ra makja mra thuhu ra toribio benavente, motolinia,	ra makja mra tuhu ra toribio benavente, motolinia
tlauhquechol: ra ts'ints'u̱ xa ntheni pode ge'a ra flamenco o ra guacamaya, pode ge gatho ra the̱nga ts'ints'u̱ ne dänga.	tlauhkečol: ra c'inc'u̱ xa ntheni pode ge'a ra flamenco o ra guacamaya, pode ge gaθo ra θe̱nga c'inc'u̱ ne däŋa.
xkri tso̱ngä ngosthi, ja hehni ya 'ñu; nä'ä rí ma nxamädo, ha nä'ä rí ma mäbo̱za. antes de	xkri tso̱nga ngosthi, ja hehni ya 'ñu; nä'ä ri ma nxamädo, ha nä'ä ri ma mäbo̱za
ya b'e̱go ne ya b'e̱tri di ge'a nu'a ra dänga ndä ra ndada ra thuhu ra esteban de guzmán ra nzaya di gekua m'onda, ra ndada ra hernando pimentel, ra ndada ra antonio cortés, ra ndada xuua (juan) nuna ra mecoyoacan, ra ndada pedro motecuhzoma, me ma r'a ya kuänmi (firmas).	ya be̱go ne ya be̱tri di ge'a nu'a ra däŋga ndä ra ndada ra tuhu ra Esteban de Guzmán ra nzaya di gekua m'onda, ra ndada ra Hernando Pimentel, ra ndada ra Antonio Cortés, ra ndada xuua (Juan) nuna ra MecoYoacan, ra ndada Pedro Motecuhzoma, me ma r'a ya kuänmi (firmas)
ya kuän' ahmä xa thogi manteb'u̱e ge xa thäst'i nu'a gatho ra nthandi to'o bi b'e̱di ge xa pu̱ngahñä nuna hmä getbu̱ n'ate ya hñäki ge ñä ya nso̱ho̱ hñäki ne xa y'oni nuna nt'ofo nehe ha ra hñäki yazi xada jä'i , ge'a nuna hñäki fadi ha ra hñämfo ko ra thuhu ra sistema braile.	ya kuän' ahmä xa thogi manteb'u̱e ge xa thäst'i nu'a gatho ra nthandi to'o bi b'e̱di ge xa pu̱ngahñä nuna hmä getbu̱ n'ate ya hñäki ge ñä ya nso̱ho̱ hñäki ne xa y'oni nuna nt'ofo nehe ha ra hñäki yazi xada jä'i, ge'a nuna hñäki fadi ha ra hñämfo ko ra thuhu ra sistema braille.
ya r'atsanoya ra sahagán, ndoxjua k'oi florentino, lib. xii, caps. xxix-xli (versión de ángel ma. garibay k.).	ya r'atsanoya ra sahagán, ndojhua k'oi florentino, lib. xii, caps. xxix-xli (versión de ángel ma. garibay k.)
despwés ya desde k'a ra momento ya k'a ya híngi bénya'wi já té bimáhhu̱ k'a ra charroya'wi	despwés ya desde k'a ra momento ya k'a ya híngi béña'wi já té bimáhhu k'a ra charroya'wi
despwés ya xo bimu̱fí pe xo diario diario bu̱ nchúi mitsu̱ k'a ra charro mi'óbí k'a ra mikwála	despwés ya xo bimfi pe xo diario diario bu nchui mitsu k'a ra charro miobi k'a ra mikwala
gopareháhé primero 'á k'a ra parte ánk'ú dínant'í	gpahrahé pʼimero 'á k'a ra pʼarte 'ank'u dinant'i
i asta fecha pues ignoro mucho pero másk'ŭ mäjámá más ndímáignorahéwi	i asta fehca pues ignoro mucho pero másk'ŭ mäjámá más ndímáignorahéwi
indu̱odiagí bastante	indʉodiagí básta
inga se̱he̱ ra nnthandi ra manhyati ne ra portuguesa nehe ra francesa, inglesa, alemana e italiana,	inga sehe ra nthandi ra manhyati ne ra portuguesa nehe ra francesa, inglesa, alemana e italiana,
k'a mädämé para ke mantenigíhé dígothó mäbähtsí pues ni modo dísufréhé	k'a mädamé para ke mantenijé dígotó mäbähtsí pues ni modo disúfréhé
kómá'u̱té ya fuente níhí	kómá'u̱te ya fuente níhi
ne bi unbabi ndunthi ya baba, bi enbabi ge mi ne da ñäui ra ndä (emperador) mi b'u̱i nuni manhyati, ne da häni ra dänga ts'ofo ra evangelio,	ne bi ūmbabi ndūnthi ya baba, bi ēmbabi ge mi ne da ñāui ra ndā (emperador) mi b'ūi nuni manhyati, ne da hāni ra dānga ts'ōfo ra evangelio,
normalmente góho	OTS: ndotha góho
panteón ga dó	pantéon ga dó
pero de sesenta pantsíthá pa gothók'ŭ kompletamente xathó ndímáfădihé	pero de sesenta pantsitha pa gothok'u kompletamente xatho ndimafadihe
pero eso sí binúhgí mängŭhé kada ná	OTS: pero eso sí binhgí măŋĕhé kada ná
"po nuya ja'i to'o mi pede ge fädi ko ra thuhu ya ""cronistas de las indias"""	"po nuya xai to'o mi pede ge fädi ko ra t'uhu ya ""cronistas de las indias"""
pues este kábádá balewa este mínimo siento sinkwenta	pues este kabáda balewa este mínimo siento sinkuenta
pues nimodo bisufré k'a más ante mäabwelitahé komo mbu̱i enkahoso ra ntsoya	pues nimodo bisufré k'a más ante mābwelitahé komo mbui enkaxoso ra ntsōya
ra nku̱t'i ra huahni ne ya ñ'udi nthutsi ra agustin yáñez 2da. edición. biblioteca del estudiante universitario, unam, 1950.	ra nkut'i ra huahni ne ya ñudi nthutsi ra Agustín Yáñez 2da edición Biblioteca del Estudiante Universitario, UNAM, 1950
solamente ya riko alkansabi	solamente ya ríhko alkansabi
xi ra tí na ta komedór 'á itsí na ta alimento k'a ra ndăni	xi ra ti na ta komedor 'a itsi na ta alimento k'a ra ndani
xo mitahá ra ntsoya mitá sínko pesos ra béhña dos sinkwenta	OTS: xō mitahá rā ntsoyā mitā sinko pesos rā behña dos cinkuenta
xo taja mä sesenta wik'a taja mä sesenta bitahkíhéya'wik'a	OTS: xo taya mä sesenta 'wik'a taya mä sesenta bitaxkíhéya 'wik'a
á panteón ga dó níhí	á mpanteón ga dó níhí
ñúdigehña dabadihíya' razo''ya' mientra más dandu̱hté	ñudigehña dabadihíya' razó''ya' mientra máhi dandu̱hté
-nu'u̱ dige'u̱ b'u̱i nuni maxey (tolimán ne amealco), dige'u̱ temoaya nuni ra ra hyodi estado de méxico ne mar'a ya hyodi nuni puebla ne veracruz	-nu'u digeu bui nuni maxei (tolimán ne amealco), digeu temoaya nuni ra ra hyodi Estado de México ne mar'a ya hyodi nuni Puebla ne Veracruz
ne mätahekitho di ja getbu̱, ra hñäpi ra joel martinez hernández ne ra hotho thuahmä ra natalio hernández xocoyotzin, nuya yoho ya xahnate ri ñ'ehe ya y'u̱ dige'u̱ ya ndeznä.	ne mätahekitho di ja getbų, ra hñäpi ra joel martinez hernández ne ra hotho thuahmä ra natalio hernández xocoyotzin, nuya yoho ya xahnate ri ñ'ehe ya y'u dige'u ya ndeznä.
"-n'ate pa n'a ra zänä de ra r'e̱t'a ma hñäto ""zänä"" mi zo̱ta ya munts'i ya n'ate ya pa ge mi hoki ra xihuitl o ""ra m'ede ra je̱ya"""	"-nte pa n'a ra tsänä de ra r'ets'a ma ñäto ""tsänä"" mi tsota ya munts'i ya n'te ya pa ge mi hoki ra shiuitl o ""ra m'ede ra hey'a"""
bi ma di gepu̱ ham''u̱ ra ngo pa da ts'ithe ya it'adehe (Tlahuano) ba po̱ni nubu̱ tlapechhuan. mra ngo ra Izcalli.	bi ma di gepʌ̃ hamʌ̃ ra ŋo pa da ts'itʰe ya it'adʰe (Tlahuano) ba põni nubʌ̃ tlapetʰuan. mra ŋo ra Iskali.
bi mu̱di da hyoka ya t'u̱kats'u̱fabo̱ja. ge'a ra ntuhni bi nja nuni Coyohuehuetzin ne ma goho ba nja.	bi mu̱di da hyoka ya t'ukats'ufabo̱ja. ge'a ra ntuxni bi nia nuni Coyohuehuetzin ne ma goho ba nia.
bri tho ra cuauhnochtli, ra gabida tlacatecco, ra cuapan, ra gabida huitznáhuac, ra makja Amantlan, ne ra makja tlacopan.	bri tho ra kwawoñotli, ra gabida tlakateko, ra kwapan, ra gabida witznawac, ra makya Amantlan, ne ra makya tlakopan.
bri ts'u̱tuabi ha ra y'u̱ga n'a ra nto̱de dega t'u̱ka hoga do dega chalchihuite: made mi huts'i n'a ra tsant'i dega k'astaboja.	bri ts'utuabi ha ra y'uga n'a ra ntode dega t'uka hoga do dega chalchihuite: made mi huts'i n'a ra tsanti dega k'astaboja
Castañeda, ra t'u ra Aquiyahualcatecuhtli, m ra ndä nuni tlaxcala.	Castañeda, ra t'u ra Aquiyahualcatecuhtli, m ra ndä nuni Tlaxcala.
Coaíhuitl mra gabida ndeznä nuya mapa digeá ra t'o̱t'ats' okamfeni.	Coaihuitl mra gabida ndeʒnä nuya mapa digea ra t'ot'atʃʼ okamfeni.
di gepu̱ ba koi pa nuni ra Xochimilco. nubu̱ ba tu ya jä'i ya metlatelolco	di ɣepu ba koi pa nuni ra Xochimilco. nubu ba tu ya ɟä'i ya metlatelolco
ebu̱ ba ehe man'aki ba te̱nga ra t'o̱ho̱ ra thuhu ra Citlaltépec. Tlacopan, nubia ba o̱t'ra b'u̱i ha ra ndo̱m'ihmu.	OTS: Ebu̱ ba Ehe Man'aki ba Te̱nga ra T'o̱ho̱ ra Thu̱hu ra Citlaltépec. Tlacopan, Nubia ba O̱t'ra B'u̱i ha ra Ndo̱m'ihmu.
ebu̱ bi dädi ra Cihuacóatl:	OTS: ebu̱ bi dädi ra Cihuacóatl
ebu̱ bi ñä ra Cuauhtémoc bi xipabi ra Cihuacóatl:	ebu̱ bi ñä ra Kwawtemok bi xipabi ra Siwakwatl:
goho n'ate ya pa ne ebu̱ bi yopa bo̱ni pa di mani ra Huaxtepec, ra Cuauhnahuac (Cuernavaca).	goxo n'ate ya pa ne ebũ bi yopa bõni pa di mani ra Wahtepek, ra Kwaunawak (Cuernavaca).
gue dá nhuat'i mbo ja ra ximhai,	OTS: gwe dá ŋwat'i mbo xa rim ximhai,
i nte ra nge'a, ya hmä huts'i ha ra ndäxjua k'oi ra códice ra ramírez uni nuna b'e̱de mä majuäni ngu mä ra nthe̱ka b'ede ne ra ndädi nu'a ra nänä mra thuhu ra yacotzin, ra nänä ra ixtlilxóchitl,	i nte ra ngē'a, ya hmä huts'i ha ra ndäxjua k'oi ra códice ra ramírez uni nuna b'ēde mä majuäni ngu mä ra nthe̱ka b'ede ne ra ndädi nu'a ra nänä mra thuhu ra yacotzin, ra nänä ra ixtlilxóchitl,
inda hyo ko ra ndäxjua ixtlilxóchtil, ra dada ra Nezahualcóyotl ni ko ra fernando de alva ixtlilxóchitl.	inda jyo ko ra ndaxhua istilxóchtil, ra dada ra Nezahualcóyotl ni ko ra Fernando de Alva Istilxóchitl.
k o ya bu̱' bai, ko ya makahuai,	kʌ ʌ ya bʌ̱ʌ bai, kʌ ʌ ya makahuai,
mi fudi da t'axka ra xudi ba ts'i, bri thát'a ha n'a ra za mi b'ai ha ra ngu ra Ahuizotzin nuni ra Acatliyacapan.	mi hudi da t'axka ra xudi ba ci, bri thát'a ha n'a ra za mi b'ai ha ra ngu ra Ahuizotzin nuni ra Acatliyacapan.
mi gu̱t'a ra ñ'u̱ n'a ra makja ge'a mra b'e̱fi mi zu nu'a ra mäka hai mra thuhu ra Yohualichan.	mi kut'a ra ñ'u ra makya ge'a mra befi mi zu nu'a ra maka hai mra tuhu ra Yohualichan.
mi y'o y'oua, mi tuts'i ya bu̱'bai dega za, ne r'a mi hä dega bo̱ja ne ya mahuai.	mi yʔo yʔua, mi tuhci ya bu̱ʔbai dega za, ne rʔa mi xä dega bo̱xa ne ya mahuaʔi.
mra ngu ra Aztautzin ge'a mi ja getbu̱ nuni ra Amáxac.	mra ngu ra Aztautzin ge'a mi xa getbũ nuni ra Amáxac.
n'a ra hyo ne man'a bi xokuabi ra debi. ra Cuauhtemoctzin bri xokuabi ra debi ge'a se̱he̱.	n'a ra hyo ne mana bi xokuaʼbi ra debi. ra Cuauhtemoctzin bri xokuaʼbi ra debi ge a sehe.
ne m'e̱fa bi ma xki häki ya he dega magabi, ñätsi bi ntsaya ra mahuai ne ra bu̱'bai, bri njonda ya bo̱nahmu nuni Acachinanco.	ne m'efa bi ma xki haki ya he dega magabi, ñatsi bi ntsaya ra mahuai ne ra bu'bai, bri njonda ya bonahmu nuni Acachinanco.
ne njabu̱ bri t'ot'e nehe ko mar'a ya bo̱nahmu mi pe̱tsi ra t'u̱ka tsu̱tui ha ya t'u̱ka hnini, nuyu̱ to'o mi b'e̱pi da t'o̱t'e ngu nuni Xalapan, Tlaxcalan, Tehuantepec, Oaxaca nehe mar'a ya bo̱nahmu mar'a ya t'u̱ka hnini habu̱ bi guat'i ya nduste, ya dumanthuhu dega k'astaboja, ge ya thuhu ya kristiano [...]	ne njabų bri t'ot'e nehe ko mar'a ya bonahmu mi pe̱tsi ra t'ųka tsųtui ha ya t'ųka hnini, nuyu̱ to'o mi b'ėpi da t'o̱t'e ngu nuni Xalapan, Tlaxcalan, Tehuantepec, Oaxaca nehe mar'a ya bonahmu mar'a ya t'ųka hnini habų bi guat'i ya nduste, ya dumanthuhu dega k'astaboja, ge ya thuhu ya kristiano
ne nu'a ri däme, pu̱ ñ'a'i, nugi ga ma ga tsogi'i nuni Cuetlachcoapan [n'a ra hnini nuni puebla],	ne nü'a ri däme, pu ñ'a'i, nugi ga ma ga tsogi'i nuni Cuetlachcoapan [n'a ra hnini nuni puebla]
ne nu'u̱ bi mani dra ts'okat'o̱t'amfeni nuni Michoacán, Xalisco, Culhuacan ne nuni nehe Pánuco, ne nuni Oaxaca, Tehuantepec ne Guatemala, ne nuua ra r'ayo mahyati, nub'u̱ bri t'o̱t'a ra mabagi pa dra uadi dra t'o̱t'a nu'a ra ts'okat'o̱t'amfeni inda tsogihe se̱he̱.	ne nu'u bi mani dra ts'okato'tamfeni nuni Michoacán, Xalisco, Culhuacan ne nuni nehe Pánuco, ne nuni Oaxaca, Tehuantepec ne Guatemala, ne nuua ra r'ayo mahyati, nub'u bri t'o'ta ra mabagi pa dra uadi dra t'o'ta nu'a ra ts'okato'tamfeni inda tsogihe sehe.
nehege'a ra ngätsi. mi hä ya mpe̱fi dega mabagi,ya njom'a te ne ya fu̱nbo̱ja, inte ma mahuai mi hä ni ge'a ya bu'bai.	nehege'a ra ngätsi. mi hä ya mpe̱fi dega mabagi, ya njom'a te ne ya fu̱nbo̱ja, inte ma mahuai mi hä ni ge'a ya bu'bai.
njabu̱ bi bo̱nga dega xui. mra ngo nub'u̱ ra Tecuílhuitl bi bo̱nga: nub'u̱ bi ja ya du ha ra r'ani ra dehe ya u̱erna.	OTS: ñabü bï bõnga dega xui. mra ngo nub'ü rä Tecuílhuitl bï bõnga: nub'ü bï ya du ha rä r'ani rä dehe ya üerna.
nub'u̱ bi thandi ra Tzihuacpopoca, bi t'ena:	nub'u̱ bi thandi ra Cihuacpopoca, bi t'ena
nub'u̱ ya ñämfo̱ bi handi ge xa ñ'ehe nubu̱ da tsu̱di, ge mi tekuabi ra nest'ihi, m'estho bi munts'i bi mihi ya mahuai.	nub'u ya ñamfo bi handi ge xa ñ'ehe nubu da tsudi, ge mi tekua bi ra nest'ihi, m'esto bi munts'i bi mihi ya mahuai.
nuna jä'i inbi tsa bi thädi majuäni nu'a ra nt'ani. ingra nge'a nuya pa bi hneki n'a ra hyoya jä'i ra macehual (hombre de pueblo),	nuna jä'i inbi tsa bi thädi majwäni nu'a ra nt'ani. ingra nge'a nuya pa bi hneki n'a ra hyoya jä'i ra macehual (hombre de pueblo)
nuna nte̱nga b'ede ha bri hat'i ra Tzihuacpopocatzin, bi o̱t'e da thogi ge'a ra ts'e̱y'e̱hmu. inbi bo̱nga nuna nt'o̱t'e bi tsu̱dihu̱ ko ma r'a ya b'e̱hni. ma ra ya ñ'ete inbi hopi da ju̱ man'aki ra ñ'u nuya ts'okate. pe nuya inbi hoki ra b'ai.	nuna ntenga b'ede ha bri hat'i ra Tzihuacpopocatzin, bi ote da thogi ge'a ra tse'y'ehmu. inbi bonga nuna nto'te bi tsudihu ko ma r'a ya be'hni. ma ra ya ñete inbi hopi da ju man'aki ra ñ'u nuya ts'okate. pe nuya inbi hoki ra b'ai.
nuua di udihe ra hñäpi bi nto̱t'e bi nja ra agosto ra je̱ya 1595, n'a ra jä'i mra thuhu ra miguel hernández, ra me Chiyauhtzinco,	nuua di udihe ra hñäpi bi nto̱t'e bi nja ra agosto ra je̱ya 1595, n'a ra jä'i mra thuhu ra miguel hernández, ra me Chiyauhtzinco
nuya bo̱nahmu ya mem'onda ñätsi bi ñäui ra Cihuacóatl Tlacotzin m'estho bi thädi:	nuya bonahmu ya mem'onda ñätsi bi ñäui ra Cihuacóatl Tlacotzin m'esto bi thädi
ra Tlacatécatl mra me Cuauhtitlan ne ra bktri ra mbot'a ngu bri japi ya tsat'yo bi zi.	ra Tlakatekatl mra me Kuauhtitlan ne ra paktri ra mbota ngu bri japi ya tsatyo bi zi
ra doy'e̱ pahni xki njom'i ko ya chalchihuite.	ra doy'e̱ pahni xki njom'i ko ya chalchihuite
ra mu̱di ra Cuauhtémoc, ra hmu ra bondo, ra nyoho ra Tlacotzin, ra Cihuacóatl ra nhñu ra oquiztzin, ra bo̱nahmu ha ra nini ra Azcapotzalco Mexicapan, ra ngoho ra panitzin, ra bo̱nahmu nuni ra Ecatepec,	ra mǘdi ra Cuauhtémoc, ra hmǘ ra bondo, ra ñoǵo ra Tlacotzin, ra Cihuacóatl ra ñǹu ra oquiztzin, ra bǘnahmǘ ha ra nini ra Azcapotzalco Mexicapan, ra ngǘǵo ra panitzin, ra bǘnahmǘ nuni ra Ecatepec
ra mu̱di ra pa mi o̱t'e ra ngo ra mäkime ra u, ra thuhu ra Huixtocihuatl	ra mu̱di ra pa mi o̱t'e ra ŋo ra mäkime ra u, ra tʰuhu ra Huixtocihuatl
ra nge'a bi mu̱ni ko ra mahuai ha ra xu̱tha nu'a to'o bi umbabi ra ji.	ra ngë'a bi muni ko ra mahui ha ra xutha nu'a to'o bi umbabi ra ji
ra nyoho, bi tho ra ndä ra Nauhtla, mra thuhu ra Cohualpopocatzin.	ra ñojo, bi to ra nda ra Nauhtla, mra tuhu ra Cohualpopocatzin.
unga ya ngue̱nda te ra ts'omu̱i mi bu̱'i ne mi japi da ntso̱m'i nuya macehualtin, njabu̱ mi thutuabi ya jä'i mi b'u̱i te ma za	unga ya ngenda te ra ts'omui mi bu'i ne mi japi da ntso'mi nuya macehualtin, njabu mi thutuabi ya jä'i mi b'u'i te ma za
xib'u̱ bri fádi ge nuya he mi ja nuni ra Cuauhchichilco, ha Xaltocan; ge mi pttsi ya ndá.	OTS: Shib'u̱ bri fadi ge nuya he mi xa nuni ra Cuauhchichilco, ha Xaltocan; ge mi ptsi ya nda.
xki mbo̱ni nubu̱ ra hyodi ra Cuehuecatitlan,	xki mboni nubu ra jyodi ra Cuehuecatitlan,
xki thete ra ixtlilxóchitl ne ra ku ra Cohuanacotzin ko ya he dega dänga ndä bi mu̱di da häni ra hoga ts'ofo ya evangelio,	xki thete ra istlilxóchitl ne ra ku ra Cohuanacotzin ko ya he dega dąnga ndä bi mu̱di da häni ra hoga ts'ofu ya evangelio,
ya dänga ñu̱ni nsafi, ya nsafi, ya mahuai, hangu nu'u̱ gatho xki tagi mbo ha ra hñe.	ya däŋga ñuni nsahi, ya nsahi, ya mahwai, hangu nu'u gatho xki tagi mbo ha ra hñe
bi o̱tuabi nu'a ra makja xki nk'ohni mra thuhu ra alonso ruiz, ge mi y'o nuni huamuxtitan (Huamuxtitlan) nuni ra hyodi guerrero.	bi o̱tua̱bi nu'a ra makya xki nk'ohi mra thuhi ra alonso ruiz, ge mi y'o nuni huamuxtitan (Huamuxtitlan) nuni ra hyodi guerrero.
di pädi xahño nuna b'e̱fi nehe yoho to'o di pädi da mpe̱fi da y'este nuya hoga do mahye̱gi ya xito, mra thuhu ra ambetz'ihuay.	di bpädi xahño nuna b'ëfi nehe yoho to'o di bpädi da mpëfi da y'ëste nuya hoga do mahyëgi ya xito, mra thuhu ra ambëtz'ihuay.
dra thoki ra nto̱de, ra ketzal dra b'e̱ nuni Coyohuacan.	dra thoki ra ntode, ra ketsal dra be nuni Coyohuacan.
e mi r'ani dega xui ra Cihuacóatl g'ea mi zoni ne mı mafi.	OTS: e mi r'ani dega xui ra Cihuacóatl g'ea mi zoni ne mı mafi
ebu̱ bi gäi habu̱ mi to̱ge ebu̱ bi yopa ma ha ra hnini ra Cuetaxtlan,	ebũ bi gai habũ mi tõge ebũ bi yopa ma ha ra hnini ra Cuetaxtlan,
ge'a ra mu̱di ra thuhu ra Hernando, ra nge'a njabu̱ mra thuhu ra takjä ra Cortés nehe njabu̱ mra thuhu ra ndä católico ne ra ku ra Cohuanacotzin bi thutuabi ra pedro po ra Pedro Alvarado ra nge'a ra takjä,	ge'a ra mu̱di ra t'uhu ra Hernando, ra nge'a njabu̱ mra t'uhu ra tajä ra Cortés nehe njabu̱ mra t'uhu ra ndä católico ne ra ku ra Cohuanacotzin bi t'utuabi ra pedro po ra Pedro Alvarado ra nge'a ra tajä,
ma n'a mi b'ai nuni teotletso, habu̱ ra ñ'u̱ pa manjuäntho pa da zo̱ni nuni ra peñón (Tepetzinco).	ma n'a mi b'ai nuni teotlétso, habú ra ñ'u pa manjuánto pa da zóni nuni ra peñón (Tepetzintli)
"mi tso̱ho̱ getbu̱ ra fu̱nga t'o̱ho̱, habu̱ mi thutuabi ""tajón ra nxu̱ni, njabu̱ bi hutuabi ya ndeznä ya b'e̱hnanoya bi pe̱hni ra ts'e̱y'e̱hmu, mi gu̱t'a ra ñ'u ra Tzihuacpopocatzin, bi bo̱nga ha ra ñ'u."	"mi tsoho getbu ra funga toho, habu mi thutuabi ""tajon ra nxuni, njabu bi hutuabi ya ndezna ya behnanoya bi pehni ra tsehyehmu, mi gut'a ra ñu ra Tzihuacpopocatzin, bi bonga ha ra ñu."
mra ku ra Cacamatzin mra bo̱nahmu nuni Tetzcoco mri ñ'oui va jä'i mi y'o mpaha.	mra ku ra Cacamatzin mra bo̱nahmu nuni Tetzcoco mri ñ'oi va jä'i mi y'o mpaha
n'a ra nto̱de dega chalchihuite, xi m'et'e dega ze̱ka do, nehe mi pe̱tsi n'a ra tsant'i de ga k'astaboja.	n'a ra ntode dega calchihuite, xi m'ete dega zeka do, nehe mi petsi n'a ra tsanti de ga k'astaboja.
ne ndunthi ya ambetz'ihuay ne mar'a hoga do mi pe̱tsi ra mu'ui:	ne ndunthi ya ambec'ihuai ne mar'a hoga do mi pe̱tsi ra mu'ui:
nehe n'a ya the̱sthi dega mboťahuaido.	nehe n'a ya the̱shti dega mbotoaidu.
nuna bi o̱t'a ra ntso̱m'i ra nge'a nehe nuya ya b'e̱datsi bi tsini ko ra Cortés ne ra Cohuanacotzin ne ra ixtlilxóchitl xki nsofo pa ra ixtlilxóchitl da gu̱ka ya jä'i ge mi zu ya hyodi, njabu̱ mi pe̱hna ajuä da t'o̱t'e.	nuna bi o̱t'a ra ntso̱m'i ra nge'a nehe nuya ya b'e̱datsi bi tsini ko ra Cortés ne ra Cohuanacotzin ne ra ixtlilxóchitl xki nsofo pa ra ixtlilxóchitl da gu̱ka ya jä'i ge mi zu ya hyodi, njabu̱ mi pe̱hna ajuä da t'o̱t'e
nuna nt'o̱t'e bi nthandi xa nts'ogi njabu̱ bri thutuabi, bi ena ge mra nzu̱te ko ma m'u̱hai ra nzu̱te ne mi thutsuabi ko ya mpe̱bi dega mabagì, habu̱ hmä ge n'a di ge'u̱ bi y'e̱nga n'a ra do, ko nge'a bi hyo, nu'u̱ mar'a ya b'e̱go ge mä ge nu'u̱ se̱he̱ ya ñämfo̱ bi hyo bi mu̱tu'a n'a ra mahuai ha ri ngati bi mu̱tuabi n'a ra nzu̱ni.	nuna nt'o̱te bi nthandi xa nts'ogi njabu̱ bri thutuabi, bi ena ge mra nzu̱te ko ma m'u̱hai ra nzu̱te ne mi thutsuabi ko ya mpe̱bi dega mabagi, habu̱ hma ge n'a di ge'u̱ bi y'e̱nga n'a ra do, ko nge'a bi hyo, nu'u̱ mar'a ya b'e̱go ge ma ge nu'u̱ se̱he̱ ya ñamfo̱ bi hyo bi mutu'a n'a ra mahuai ha ri ngati bi mutuabi n'a ra nzu̱ni.
ra Cuauhtémoc, Tlacotzin, ra Cihuacóatl, Oquiztzin, Panitzin, Motelhuihtzin; nuna bi sofo ra Cortés nuni Coyoacan, nu'u̱ to'o mi pädi yoho ya hñäki ngu'a ra jerónimo aguilar ra malintzin.	ra Cuauhtémoc, Tlakotzin, ra Siwakóatl, Okitsin, Panitsin, Motelwihtsin; nuna bi sofo ra Cortés nuni Koyoakan, nu'u to'o mi pädi yoho ya hñäki ngu'a ra Xerónimo Aguilar ra Malintsin.
t'ena ge ya macehual [ya jä'i b'u̱i ha ra hyoya]	t'ena ge ya macehual [ya jä'i bʼui ha ra hyoya]
"xki thokuabi nuya hotho ts'ints'u̱ mra thuhu ra ""tlauhquecho"" ne “tzinitzcan zacuan"","	"xki thokuabi nuya hoto ts'ints'u mra thuhi ra ""tlauhquecho"" ne “tzinitzcan zacuan”"
-¿te be'a gi mä nu'i Cihuacóatl?	-¿te ve'a gi mä nü'i Cihuacóatl?
bi k'ahni ko ya dänga ñuni nzafi ne bi thetse ko ya makahuai nuya otomi geb'u̱ bi japi bi b'e̱di, bi mä nuyu̱:	bi k'ahni ko ya dangã ñuni nzafi ne bi thetse ko ya makahuai nuya otomi geb'u bi japi bi b'edi, bi mä nuyu
da thuts'i ya njot'ihñä ( )	da thuts'i ya ñjot'ihñä
da umbabihe te da zi, da japabihe ndunthi ma zu.	da ūmbabihe te da zi, da japabihe ndūnthi ma zu.
ebu̱ bi mä nuna b'e̱fi xa thoki xahño bi johya ra ts'e̱y'e̱hmu.	ebu̱ bi mä nuna b'efi xa thoki xahño bi johya ra ts'ey'emhu
"fernando alva ixtlilxóchitl, xiii njändahmä ""ra ñ'ehe ya ñämfo̱ ne ra mu̱di ra hoga ts'ofo ra evangelio."""	"Fernando Alva Ixtlilxóchitl, XIII njändahmä ""ra ñ'ehe ya ñämfo̱ ne ra mu̱di ra hoga ts'ofo ra Evangelio."""
ga juatihu̱ nu'a huts'i njani, ya ts'ojä'i, ra carranza, ge xa o̱t'a ya ts'okuate pa gekagihu̱; ga o̱t'e da nja ra ts'e̱di ma munts' ne njabu̱ ga tsu̱dihu̱ da nja nu'a ra hoga tsu̱tui, da nja ra hai, ra hñegi ne ra hoga ts'u̱tui;	ga juatiᵘ nu'a huts'i njani, ya ts'oja'i, ra carranza, ge xa oᵘta ya ts'okuate pa gekagihᵘ; ga oᵘte da nja ra ts'edi ma munts' ne njabᵘ ga tsᵘdihᵘ da nja nu'a ra hoga tsᵘtui, da nja ra hai, ra hñegi ne ra hoga ts'ᵘtui;
gatho ya hyoyajä'i mi b'u̱i ha ra hnini bi handi.	gaʔtho ya ɣoyajä'i mi bʼu̱i ha ra ɣnini bi handi
ha bi häni ra ñ'udi, ma jä'ihu̱ bi ent'i gatho mahye̱gi nuya nzu̱te	ha bi hani ra ñudi, ma jaihu bi ent'i gato mahyegi nuya nzute
ha n'aa nza̱tho xudi ra pale berto, bi bo̱ni nda hyonga te nda nzimxidi ngetho nda zi ya hme hyaxtho mi u̱xa ya u, ua ngu mi nzäi mi nkahui yá hme nuya chuju̱ xa hogi ha nuya 'bomuha̱i nts'ät'i, nt'o̱kuä;	ha n'aa nzatho xudi ra pale berto, bi boni nda hyonga te nda nzimxidi ngetho nda zi ya hme hyaxtho mi uxa ya u, ua ngu mi nza'i mi nkahui ya hme nuya chuju xa hogi ha nuya 'bomuha'i nts'at'i, nt'okuä;
ha nubia di ndäki, di ndändiñähmu, di ma ga ts'u̱tsa'i ri y'e, ga ndäne'i ra nge'a nu'a'i ma makjahe, ra bartolomé lópez, nub'u̱ mi njuäni ma b'e̱hña inbi njuäni ha nubu̱ mi xaxi pa da o̱t'a ya tso̱mfen	ha nubia di ndäki, di ndändiñähmu, di ma ga ts'u̱tsa'i ri y'e, ga ndäne'i ra nge'a nu'a'i ma makjahé, ra bartolomé lópez, nub'u̱ mi njua̱ni ma b'e̱hña inbi njua̱ni ha nubú mi xaxi pa da o̱t'a ya tso̱mfe̱n
ha ya t'u̱ka ze̱ki thuts'i n'a tu̱kitho nuna thogi ge bi huxa ra fernando alva ixtlilxóchitl, nu'a b'e̱tsi ra xiiii njondahmä.	ha ya t'uka zeki thuts'i n'a tukitho nuna thogi ge bi huxa ra Fernando Alva Ixtlilxóchitl, nu'a bets'i ra XIIII njondahma.
habu̱ ga ju̱he nuyu̱ (ya tenochcas) te gi honihu̱?	habų ga jųhe nųyų (ya tenochcas) te gi hŏnių?
ham'u̱ gatho ya juän'ahmä ge nuua xa ze̱ti ri ñ'ehe dige'a ya noya ya mu̱dimehai ha ra hñä ya ndeznä, nuna thuhu ri uni inga se̱he̱ ra n'atsanoya pa da fädi ra hñämfo̱, ingi ri me̱udi dige'a ra hmä fu̱oti dige'a nuna ra hñäki ra netzahualcoyotl. ne ra cuauhtémoc.	hamʉ gatho ya juänʔahmä ge nuua xa zeti ri ñʔehe digeʔa ya noya ya muʉdimehai ha ra hñä ya ndeznä, nuna thuhu ri uni inga sehʉ ra nʔatsanoya pa da fädi ra hñämfo, ingi ri meʉudi digeʔa ra hmä fuʉoti digeʔa nuna ra hñäki ra netzahualcoyotl. ne ra cuauhtémoc.
mi hneki ngu ma jä'ihu̱ ngabu̱ mri hneki.	mi ɲeki ŋu ma xáʔiŋu ŋabu mɾi ɲeki.
ndunthi bri johya, bri thuxpabi gatho nu'a mi o̱t'abi ra b'edi, ko nge'u̱ bi m'u̱i ne mi t'umbabi ya t'ixu:	ndunthi bri johya, bri thuxpabi gatho nu'a mi o̱t'abi ra b'edi, ko nge'u̱ bi m'u̱i ne mi t'umbabi ya t'ixu
ngu mra me̱ti, nu'a r'a hyodi, habu mi y'o, n'a ngu n'a mi johya mi mfe̱m'a xinxi xi mi johya ya ndäte, mi thede n'a ngu n'a mi hñu̱fi ne mi fe̱m'a ya xinxi: xi mi b'u̱i mpaha.	ngu mra meti, nu'a r'a hyodi, habu mi yo, n'a ngu n'a mi joya mi mfema xinxi xi mi joya ya ndate, mi tedé n'a ngu n'a mi hñufi ne mi fema ya xinxi: xi mi bui mpaha.
njabu̱ ri ñ'ehe ya je̱ya inda m'e̱di, inda mpumfri, ga nzäi ga pe̱tsi nugagihu̱ ha ma mfenihu̱, ga pe̱tsi nugagihu̱, ra bätsi dige'u̱, ya b'e̱to, ya ntsaniku, ya mbänga b'e̱to ne to'o dra ñ'epu̱, to'o mahye̱gigihu̱, ma jihu̱, ya ku̱hu̱.	njabu̱ ri ñ'ehe ya je̱ya inda m'e̱di, inda mpumfri, ga nzäi ga pe̱tsi nugagihu̱ ha ma mfenihu̱, ga pe̱tsi nugagihu̱, ra bätsi dige'u̱, ya b'e̱to, ya ntsaniku, ya mbänga b'e̱to ne to'o dra ñ'epu̱, to'o mahye̱gigihu̱, ma jihu̱, ya ku̱hu̱
nu xä oth'u̱, ma gä ñ'jähu̱	nu xä oth'u, ma gä ñjahu
nuga̱ xi di ne'i, hindi pädi hanja...	nuga̱ xi di ne'i, hindi pa̱di hanja...
num'u̱ di johyahu̱, nkuehu̱, nts'o̱mihu̱, tsuhu ne pa da t'o̱xkähu̱ di hohñu̱ nu ya nt'u̱i xi di 'yoohu̱ (¡!). nuya da nt'ot'i ko ra dänt'ot'í	num'u di johyahu, nkuehu, nts'omihu, tsuhu ne pa da t'oxkahu di hohñu nu ya nt'ui xi di 'yoohu (¡!). nuya da nt'ot'i ko ra dant'ot'i
nuna bi johya ha ra mabagi,	OTS: nuna bi joya ha ra mabagi,
nuya hñu o gohoya pa bi b'u̱i nubu̱ bi xitsuabi ra jäpadehe ndunthi ya jä'i, ngu xa t'ena.	nuya hñu o gohoya pa bi bʼui nubu bi xitsuaʼbi ra ʒäpadeʼhe ndunʼthi ya ʒäʼi, ngu xa tʼena
nuya tsat'io mi b'et'o, mi gu̱t'a ra ñ'u, mi teni, ya xiñu mi ju̱ts'i pa mañä, xi mi pähä gatho mi handi mi nest'ihi: mi tu̱ta ya jihni	nuya tsatio mi beto, mi gut'a ra ñu, mi teni, ya xinu mi juts'i pa maña, xi mi paha gato mi handi mi nestihi: mi tuta ya jihni
pe, nu'i ndada nu'i ma t'ek'ei ra makja, nub'u̱ nu'i ingi zugagihe, ¿hanja, nuua, ra hyo di ge'a, ga tsogi nubu̱ [nu'a ma b'e̱hña]?	pe, nu'i ndada nu'i ma t'ek'ei ra makya, nub'u nu'i ingi zugaxihe, ¿hanja, nuua, ra hyo di ge'a, ga tsogi nubu [nu'a ma b'ehña]?
r'a ya jä'i mi b'u̱i ha ra ngumi ja nunu ha ra hnini ri manjuäntho pa da tsoni nubu̱ ra amáxac,	r'a ya jä'i mi b'ui ha ra ngumi ja nunu ha ra hnini ri manjuäntho pa da tsoni nubu ra amáxac,
ra nge'a di o̱t'a nuna noya ra ts'u̱tui ne gatho to'o da guat'a ha ma hyohe, nu'u̱ to'o da ne, da me̱tsi n'a ra hoga m'u̱i ne da m'u̱i manjuänthä. ha nubu̱ xa mabu̱ ma noya ge di pe̱tsi ra tsa, dega hoga jä'i ne dega hogat'o̱t'antuhni	ra ngë'a di o̱t'a nuna noya ra ts'utui ne gatho to'o da guat'a ha ma hyohe, nu'u̱ to'o da ne, da me̱tsi n'a ra hoga m'ui ne da m'ui manjua̱ntä. ha nubu̱ xa mabu̱ ma noya ge di pe̱tsi ra tsa, dega hoga ja'i ne dega hogat'o̱ta̱ni
ra ngehna nuna pa bi ma n'a ra ñ'u manjuäntho.	ra ngëhna nuna pa bi ma n'a ra ñ'u manjuantho
ra nhñu ne ra ngästsi ra b'ist'ofo di huts'ihu̱ ha nuna ze̱ki b'ist'ofo, ri ñ'ehe ra vii njondahmä ra chimalpain,	ra nhñu ne ra ngätsi ra b'ist'ofo di huts'ihu ha nuna zeki b'ist'ofo, ri ñ'ehe ra vii njonda hmä ra chimallpain,
ra nthädi ra cuitlahuacatzin bi ena ge ina da o̱t'e nuya bi b'e̱pabi ya nso̱ho̱jä'i,	ra ntʰädi ra kuitlahuakatsin bi əna ge ina da o̱tʼe nuya bi bʼäpabi ya nsʼoho̱jäʼi,
ra nyoho nu'a mi zu ra tepoztlan; ra nhñu ra me tizatlan, ra njoho mi ñ'ehe nuni huehuetlan ne ra nku̱ta mra dänga mictlan.	ra nyoho nu'a mi zu ra tepoztlan; ra nhñu ra me tizatlan, ra njoho mi ñ'ehe nuni huehuetlan ne ra nkuhta mra dänga mictlan.
ri ñ'udi xahño nubia hanja beni ya metlaxcala bi do̱m'i mpaha nuya nso̱ho̱ jä'i.	ri ṅudi xahño nubia hanja beni ya metlaxcala bi ḍo̱m'i mpaha nuya nso̱ho̱ jä'i
t'ena ge inbi unga mfädi pa gatho ya jä'i mi ñ'oui, ge nuna ndada ra marqués da ñ'ehe dra hmu ha ma haihe, da ja me̱ti nu'a di pe̱tsihe nehe dra jakagihe ga mpe̱fihe ra hai ge bi umbabi o bi hänbabi ya hoga hai ya n'añ'o hnini.	t'ena ge inbi unga mfädi pa gatho ya jä'i mi ñ'oui, ge nuna ndada ra marqués da ñ'ehe dra hmu ha ma haihe, da ja me̱ti nu'a di pe̱tsihe nehe dra jakagihe ga mpe̱fihe ra hai ge bi umbabi o bi hänbabi ya hoga hai ya n'añ'o hnini
xi mi taxki ra ñ'u, imbi tsa da r'anga n'a, ho̱nse̱he̱ mi taxka n'a ha ra bo̱hai. ya y'ofadi mi ju̱t'atho.	xi mi taxki ra ŋ'u, imbi tsa da r'anga n'a, honsehe mi taxka n'a ha ra bohái. ya y'ofadi mi jut'atho.
ya dänga mfu̱nga bo̱jä bi ntho, bi kot'i ko ya mahjuai, mi zu̱m'i nehe ko ya t'e̱nga ts'u̱t'abo̱ja.	ya däŋga mfu̱ŋga bojä bi n̄tho, bi kot'i ko ya mahjua̱i, mi zum'i nehe ko ya t'äŋga ts'ut'abo̱ja
ya r'atsanoya ra sahagún mi mä hanja mi yopa tsini. ya ndeznä bi nkohi inda ñ'udi. mi hatatho pa bi mu̱di ra ntuhni	ya r'atsanoya ra sahagun mi mä hanja mi yopa tsini. ya ndeznä bi nkohi inda ñ'udi. mi hatatho pa bi mu̱di ra ntuhi
ya zi b'e̱hña mi ägi ha ya b'a ne ha ya ngo̱de, nuya ñ'o̱ho̱ mbo ha ya ne, ha ya njom'ahudi.	ya zi b'ehña mi ägi ha ya b'a ne ha ya ngode, nuya ñ'oho mbo ha ya ne, ha ya njom'ahudi
bi boxro xi 'be̱ts'ina, bido'u̱ ro 'yu̱ni 'na, xi bi bo̱x ro hjua 'na, bido'u̱ ro ts'ii 'na, xi bo̱xro ts'äre 'na. ge'bu̱ go min pu̱n doja 'na.	bi boxro xi bets'ina, bido'u ro yuni na, xi bi box ro hua na, bido'u ro tsii na, xi boxro tsare na. gebru go min pun doja na.
bi ma manjuäntho habu̱ mi b'u̱i ra ts'e̱y'e̱hmu bi xipabi;	bi ma manju̱antho habu̱ mi b'ui ra tse̱e̱hmu bi xipabi;
bri juahni po nuya dra hmu.	bri xuaʔni po ɲuʔa dra ʰmu
di to̱m'ihe ra ñ'ethi pa nugagihe, n'a ra pa ngu ma n'a ra pa thogi nekagihe di huadihe ra nge'a indi tse̱tihe nuna b'u̱i t'o̱t'e ko ngekagihe man'año ya ntho, t'e̱nts'igihe thi ma haihe ma me̱tihe, ju̱kagihe ga mpe̱fihe ndunthi, b'e̱kagihe ga jut'ihe xdunthi ya boja, n'a ngu n'a ra pa nuna njut'i di o̱t'ehe man'a te ma thaihe di tuhe.	di tom'ihe ra ñethi pa nugagihe, na ra pa ngu ma na ra pa thogi nekagihe di huadihe ra nge'a indi tsetihe nuna b'ui tot'e ko ngekagihe manaño ya ntho, tents'igihe thi ma haihe ma metihe, jukagihe ga mpefihe ndunthi, bekagihe ga jut'ihe xdunthi ya boja, na ngu na ra pa nuna njut'i di ot'ehe mana te ma thaihe di tuhe.
gatho nuna hai ha nuna r'ayo ximhai njabu̱ bi thutuabi nuya nso̱ho̱jä'i inbi tsa bi thutuabi man'a ra thuhu.	gaʔtho nuña hai ha nuña r'ayo ximhai ñabu hi thuhtuabi nuña nsohohi inbi tsa hi thuhtuabi man'a ra thuhu.
ha mi tso nde, bi mu̱di bi nja n'a ra hneki ngu njagihu̱ dega jä'i, bi t'ot'e ra b'ai ngu dega jä'i,	ha mi tso nde, bi mu̱di bi nya n'a ra hneki ngu njagihu̱ dega yä'i, bi t'ot'e ra b'ai ngu dega yä'i,
ma bo̱nahmu'ihe: nuna b'e̱fi ga tsokagihe sta juatihe gatho: gi nuti nuua, xa hño bo̱nahmu.	ma bonahmu'ihe: nuna be'fi ga tsokagihe sta juatihe gatho: gi nti nuua, xa hño bonahmu.
mi mä dega ts'e̱dira hñä tso̱pu da ts'o̱ho̱bu nuya nzo̱ho̱jä'i ga handihu̱ te ma ts'e̱di pe̱tsi, ra nge'a ma ajuä ra quetzalcohuatl b'u̱i nuua ko ngekagihu̱,	mi mä dega ts'edirá hñä tso̱pu da ts'o̱ho̱bu nuya nzo̱ho̱jä'i ga handihu̱ te ma ts'edi pe̱tsi, ra nge'a ma ajua ra quetzalcohuatl b'u̱i nuua ko ngekagihu̱,
ne ya nt'u̱i, hanja di thuts'i ya nt'ofo, njap'u̱ nehe mä 'ra ya mpeu̱i da fats'i di nt'ot'i ra hñähñu	ne ya nt'ui, hanja di tuts'i ya nt'ofu, njap'u nehe ma 'ra ya mpeui da fats'i di nt'ot'i ra hñahñu
nub'u̱ nu'i ingi japi da bo̱nga nu'a ra makja ha nu'a ra hnini, ¿hanja ra yotui, ga tso̱gi nubu̱ ma b'e̱hña? o̱t'a r'ato ya je̱ya bi mu̱di [ra makja ra bartolomé lópez]	nub'u nu'i ingi japi da bo̱nga nu'a ra makya ha nu'a ra hnini, ¿hanja ra yotui, ga tso̱gi nubu ma b'e̱hña? o̱t'a r'ato ya je̱ya bi mu̱di [ra makya ra bartolomé lópez]
pa ga b'u̱i mpaha ne ga o̱t'e n'a ra njondahmä gatho nu'a ga handi.	pa ga bʉi mpaha ne ga oʔte n'a ra ñoɲdahmä gatho nu'a ga handi.
r'a nuna mi nthandi ngu nu'a ma thänjuahu̱ (ychtlilmatli), xi mra nts'o, mi kuet'e ha ya ngo̱,	r'a nuna mi ndandi ngu nu'a ma thänjahu (ytechtlilmatli), xi mra nts'o, mi kuet'e ha ya ngo,
xa zägi mpaha, nub'u̱ xa njabu̱ xa japabi ma zu ne inte xa t'o̱tuabi nub'u̱ inda japi xa po̱ho̱ bi ya kue̱ ra nge'a ya jä'i xi mra no̱t'e ne mra hyotejä'i,	xa tsägi mpaha, nub'u tsä njabü tsä jababi ma tsu ne inte tsä t'otüabi nub'u inda jabi tsä pöhö bi ya kue rä ngä'a ya jä'i xi mra no't'e ne mra hyotejä'i,
y'o, ri ma ne gi xipabihu̱ ya metlaxcala ge ma r'a ya me̱ti jä'i ne ri ajuähu̱, ge nu'a ga mä ge xa ehe nuua ma haihu̱, ge di umbabihe ma nthädihe.	yʔo, ri ma ne gi xipabihʊ ya metlaxcala ge ma rʔa ya me̱ti xäʔi ne ri axuähʊ, ge nuʔa ga mä ge xa ehe nuʊa ma haihʊ, ge di umbabihʊ ma ntʰädihe.
¿te da o̱t'e ma jä'ihu̱ sta b'e̱dihu̱?	¿te da o̱t'e ma jahi̱u̱ sta be̱di̱u̱?
-da ts'iua:... ri ñ'ehe ge'a ma njueih'u̱. da o̱t'ehe ya ñ'o̱te ko ya he̱m'i, ya ñ'o̱t'ehe ko ya ntuts'i. da o̱ts'e̱ ra b'e̱na noya.	-da ts'iuá... ri ñ'ehe ge'a ma ñiuehú. da otehe ya ñ'ote ko ya hem'i, ya ñ'otehe ko ya ntuts'i. da ots'e ra beña noya.
-dom'i ma ajuähu̱ ge inda yu̱t'a ha ma nguhu̱ nuhu̱ to'o e̱nts'i pa thi ne da hokuabi ra honanhyo nub'u̱ sta ne da hyoki ya inda za.	-domi ma ajua̱u ge inda yu̱ta ha ma ngu̱u nu̱ to'o e̱nc'i pa thi ne da hokabi ra honani̱u nub'u̱ sta ne da hi̱oki ya inda za
-o̱t'a ra mäte gi o̱dehu̱, ja gi b'ai nuuahu̱. mont'a ya ngo ajuä; ri juat'i ra ngo ga tsunda ma ajuähe.	-ota ra mate gi odehu, ja gi b'ai nuahu. mont'a ya ngo ajua; ri juati ra ngo ga tsunda ma ajuahe.
-xa hño, di b'u̱ihe njamädihe.	-ša hño, di bʼuihe njamädihe.
-¿nguande njabu̱ ga mäu gra juähu̱?	-¿ngwande njabu̱ ga mäu gra juähu̱?
-ñ'emabagi, ya gabida, ya jä'ihu̱ gi pädi ra ntuni ra mem'onda ba ehehu̱ ga te̱nihu̱ma nzu̱tehu̱. ko ya mätsa mi te̱he̱, ko ya bu̱'bai ko ngatho ra ts'e̱di mi te̱he̱ ra ñ'u.	-ñ'e̱mabagi, ya gabida, ya jä'ihu̱ gi pädi ra ntuni ra mem'onda ba ehehu̱ ga te̱nihu̱ma nzu̱tehu̱. ko ya mätsa mi te̱he̱, ko ya bu̱'bai ko ngatho ra ts'e̱di mi te̱he̱ ra ñ'u
bi tse̱ti nuna ngot'i ra m'onda, ngu pede ra dänga b'ede, ya k'oi ne ya njändahmä, ngu nu'a ra hmä ra alonso axayaca, goho n'ate ma pa bi nzo̱t'e nuna pa.	bi cëti nuna ngoti ra m'onda, ngu pede ra dänga b'ede, ya k'oi ne ya njändahmä, ngu nu'a ra hmä ra alonso axayaca, goho n'ate ma pa bi nzöte nuna pa.
into y'o manjuäntho, into pa ri nektho.	into yʼo manjuąntho, into pa ri nektho
nub'u̱ ndi umbabihe ma njut'ihe xki nzäi ndi da'ihe, mi adi n'a tu̱ki nehe nub'u̱ ndi unihe ya k'astaboja mi häni made n'a tu̱ki [...]	nubʼu ndi umbabihe ma njutʼihe xki nzäi ndi daʼihe, mi adi nʼa tu̱ki nehe nubʼu ndi unihe ya kʼastaboja mi häni made nʼa tu̱ki [...]
ya miñ'o ko ngehna hmä ri johya,	ya miŋ'o ko ŋehna hmä ri johya,
bi tso̱hso̱ ra ngo ma ajuähu̱: nubia da fu̱di da guadi ra r'e̱t'a ra pa.	bi c'o̱hso̱ ra ŋo ma ajua̱: nubia da fudi da guadi ra r'eta ra pa.
