Input	Result
"-pasadores: ""ya nts'äza xi mra nts'u̱t'i mi t'e̱ni ko n'a ra t'e̱nga ts'u̱t'a bo̱kja mi tjutuabi ra ballesta""."	Ya nts'äza xi mra nts'u̱t'i mi t'e̱ni ko n'a ra t'e̱nga ts'u̱t'a bo̱kja mi tjutuabi ra ballesta.
cantares mexicanos, biblioteca nacional de méxico, ya nt'ofo 1628 bis, folio 16 v.	Cantares Mexicanos, Biblioteca Nacional de México, ya nt’otho 1628 bis, folio 16 v.
"ebu̱ bi bo̱ni, bi meui nuni nonohualco, ja ra ngu ra b'ongui jabu̱ ra gabida ne ra malintzin ne ""ra jyadi"" (alvarado) ne ra sandoval."	"Ebu̱ bi bo̱ni, bi meui nuni nonohualco, ja ra ngu ra b'ongui jabu̱ ra gabida ne ra malintzin ne ""ra jyadi"" (Alvarado) ne ra Sandoval."
gi jandi ra nt'ofo ra tjuju ra crónicas de la conquista	Gi hñänt'i ra nt'otho ra t'ot'u ra crónicas de la conquista.
guzmán. ja ya je̱m'i b'e̱tsa kje̱ya manteb'u̱ di ge nuua m'onda ne ya jyo, nu'a ra jmä ra 12-conejo (1530) ge xa jmä ge xibú bi yut'i ja ra culhuacan ya ndeznä, nda pablo xochiquetzin, motelchiuhtzin ne ra guzman.	Guzmán. Ja ya hñäm'i b'ëtsa kje̱ya manteb'u̱ di ge nuä m'onda ne ya jyo, nu'a ra hñä ra 12-Conejo (1530) ge xa hñä ge xibú bi yut'i ja ra Culhuacan ya ndeznä, nda Pablo Xochiquetzin, Motelchiuhtzin ne ra Guzmán.
ja ga ñ'udiju̱ ra nt'ofo ya ñämfo̱ po ra ntjuts'i ra doctor garibay,	Xa ga ñ'udi̱ju̱ ra nt'ofo ya ñämfo̱ po ra nt'uts'i ra doctor Garibay,
ja nu'a jyodi nubia tjutuabi ra san martin.	Xa nu’ä ñudi Nubia chuchuäbi ra San Martín.
je̱mi unga mfädi ja ra t'u̱ka jnini jabu̱ b'u̱i ya kjä'i teni ra división ra arenas, 27 ra abril ra kje̱ya 1918, ra m'ets'a je̱m'i ra zapata, b'e̱tsi ja ra universidad nacional autónoma de méxico, expediente 29.	Jämi hñä mfädi ja ra t'uka hñeni hñabu b'ui ya kjä'i teni ra división ra arenas, 27 ra abril ra kjea 1918, ra m'ets'a jämi ra zapata, b'ets'i ja ra universidad nacional autónoma de méxico, expediente 29.
"m'e̱fa ja ra jñuti bri tjätuabi na ra jñe xki tagiri mo̱te, neje bri kjom'a ra xu̱tja ko n'a ra t'axa dutu mra tjujuu ra ""campanillante""."	M’efa ha ra ñuti bri tyätuabi na ra ñä xki tagiri möthe, neje bri kyom’a ra hütxa ko n’a ra t’axa dutu mra tjuju ra “campanillante”.
ma dada'ije gra ts'u̱tui, di ne gi pädi ge ma me̱t'o instä tjogije nuna tjogi gatjo ya mapa xki r'ani, bi kjuat'i ko ngeke nu̱'u ri b'e̱go, ri me̱fi ya ñämfo̱, ra nge'a makjuäni ra hernando cortés ra ndä gabida,	Ma tadajye gra ts'utui, di ne gi pädi ge ma me̱tho instä tjogije nuna tjogi gatjo ya mapa xki r'ani, bi kjuat'i ko ngeke nu̱'u ri b'e̱go, ri me̱fi ya ñämfo̱, ra nge'a makjuäni ra Hernando Cortés ra ndä gabida.
mi b'u̱i ya mu̱dimejai mi ñä ra ndeznä ne jabu̱ ra jnini dige'a gatjo ra nxiki m'onda ngu r'a ya yaqui b'u̱i nuni sonora ne ya maya ri ñ'eje nuni yucatán ra nge bi guat'i ja ra tujni bi nkja nuua m'onda fädi ko ra tjuju ra revolución mexicana ya kje̱ya 1910-1919.	Mi b'ui ya mu̱dimehai mi ñä ra ndezna ne hñabu̱ ra jñeni dige'a gatjo ra nxiki m'onda ngu r'a ya yaqui b'u̱i nuni Sonora ne ya maya ri ñ'eje nuni Yucatán ra nge bi guat'i ja ra tujni bi nkja nuua m'onda fädi ko ra tjuju ra Revolución Mexicana ya kje̱ya 1910-1919.
mi fo̱tuabi ya ts'u̱tnibo̱kja mi tjutuabi ya jñämfo̱ ra pasadores neje ya bo̱zna ko ya nzafi.	Mi fotuabi ya ts'utnibokjä mi tjutuabi ya ñämfo ra pasadores neje ya bozna ko ya nzafi.
n'a nt'udi di ge'a nuya ntjoki bri t'o̱t'e ja ya jñä ya ndeznä ra ngätsi ra ntjebe nkje̱ya ra r'e̱t'a ma gu̱to (s. xix), r'a ya jnini ngu ra xicontepec (villa juárez) nuna jyodi koji nuni puebla.	N’a nt’udi di ge’a nuya nt’oki bri t’ot’e ja ya ñä ya ndetsnä ra ngätsi ra nt’ebe nk’eiya ra r’et’a ma guto (s. xix), r’a ya ñuni ngu ra Xicontepec (Villa Juárez) nuna yodi koji nuni Puebla.
"n'a ra t'axa dutu mi pe̱tsi ya k'oi ra ixki, nuna mra tjuju jñämfo̱ ""campaneante resonador""."	N’a ra t’axa duthu mi pe̱tsi ya k’oi ra ixki, nuna mra tjuju ñämfo̱ “campaneante resonador”.
ne ri mpe̱fi ja ra dängan gu nt'udi ra tjuju ra facultad de estudios superiores, acatlán, unam,	Ne rï mpe̱fi ja ra dängandä gui nt'udi ra tjuju ra Facultad de Estudios Superiores, Acatlán, UNAM.
ntjandi gatjo nu'a ra munts'i ra tjuju jñämfo̱ ra globalización ge 'a po̱ts'e dega nest'iji, nuna y'o̱te to̱m'i da nkja ra ntjo̱mäte.	Nthandi gahts'o nu'ä ra mints'i ra ts'uju ñämfo̱ ra globalización ge 'ä po̱ts'e dega nehts'iji, nuna y'o̱te to̱m'i da nkä ra nthomäte.
nu'a ma r'a ya kjä'i mi pädi nuña b'e̱fi bri b'e̱pabi xa jyoki yojo ya mpe̱fi mi fädi ko ra tjuju ra amosqueador ko ya xi ya ts'ints'u̱ xi sta jotjo, gi jutsuabi made dige'a n'a ra zänä dega k'astabokja	Nu'a ma ra ya kä'i mi pädi nuña b'efi bri b'epabi xa yoki yoho ya mpefi mi fädi ko ra tjuju ra amosqueador ko ya xi ya ts'ints'u xi sta jotjo, gi jutsuabi made dige'a n'a ra zänä dega k'astabokja.
"nu'a ra munts'a kjä'i bi te̱ni bi zipabi man'a ya b'ede, mi t'ena ge ya kjä'i xki b'u̱i nubu̱ inbi pe̱tsi ra ts'e̱di nu'a mi mä pe m'e̱fa bi kjapi bi nxaxni ya tsu̱tui ne n'a ra diputado mi pe̱tsi ra mfeni xki kot'i mra tjuju ra josé maría lozano, bi y'onga ra jmä pa mar'a ya ñ'oui bi nxanxi: ""ri mo̱te ra tjits'i mi udi ra emiliano zapata, neje bri fädi ngu ra atila nuna bri nkju̱tsi [...] nu'a bi fädi ngu mi je̱gi ya b'e̱go ne'a bi mä da uni da nkja pa gatjo, ingi kjot'i [...]"	"Nu'a ra múnthä kjä'i bi te̱ni bi zipabi man'a ya b'ede, mi t'ena ge ya kjä'i xki b'u̱i nubu̱ inbi pe̱tsi ra ts'e̱di nu'a mi mä pe m'e̱fa bi kjapi bi nxaxni ya tsu̱tui ne n'a ra diputado mi pe̱tsi ra mfeni xki kot'i mra tjuju ra José María Lozano, bi y'onga ra jmä pa mar'a ya ñ'oui bi nxanxi: ""Ri mo̱te ra tjits'i mi udi ra Emiliano Zapata, neje bri fädi ngu ra Atila nuna bri nkju̱tsi [...] nu'a bi fädi ngu mi je̱gi ya b'e̱go ne'a bi mä da uni da nkja pa gatjo, ingi kjot'i [...]"
nu'u̱ to'o ñä ra ndenzä ja r'e̱t'a ma r'at'o ya estados.	Ñuhu to'o ñä ra nthe̱nthe ya r'e̱t'a ma r'at'o ya estados.
nub'u̱ ri m'e̱jni ne ri b'e̱go ya ñämfo̱ bi kjuat'i ko ngekagije ne bi tso̱jo̱ ra gabida ra tjuju ra hernán cortés, maske indi pädije ge gatjo da za da o̱t'e ne xi ra nzunda maría trinidad,	Nub’ú ri m’ejni ne ri b’ehño ya ñämfo̱ bi kjuat’i ko ngekagije ne bi tso̱jo̱ ra gabida ra tjuju ra Hernán Cortés, maske indi pädije ge gatjo da za da o̱t’e ne xi ra nzunda María Trinidad,
nubia, unga mfädi ja ra ñäjñu kjamädi ra universidad autónoma del estado de hidalgo.	Nubia, 'na mfädi ya ra ñäñu kjamädi ra Universidad Autónoma del Estado de Hidalgo.
nugi, ra miguel hernández ge di pe̱tsi ma ngu nuni chiyauhtzinco, ko ra t'ek'ei di udi ko nge'i, nuna m'e̱jnant'ofo di joki go tso̱n'i ko nge'i, ma t'ek'ei bo̱najmu'i nda doctor alonso ruiz, ra nk'ojnate ge gi b'ui nuua ja ra jnini ra quamochtitla.	Nugi, ra Miguel Hernández ge di pe̱tsi ma ngu nuni Chiyauhtzinco, ko ra t'ek'ei di udi ko nge'i, nuna m'e̱jnant'ofo di joki go tso̱n'i ko nge'i, ma t'ek'ei bo̱najmu'i nda doctor Alonso Ruiz, ra nk'ojnate ge gi b'ui nuua ja ra jnini ra Quamochtitla.
nuna je̱m'i bri t'unga mfädi ko ra t'u̱ka ntjint'ant'ofo po ra marcelo díaz salas ne ra luis reyes garcía ja: tialtocan, revista de fuentes para el conocimiento de las culturas indígenas de méxico, vol. vi, 1970, b'ede ra 3, pp. 193-212.	Nuna jäme bri t'unga mfädi ko ra t'uka nt'ënt'ant'otho po ra Marcelo Díaz Salas ne ra Luis Reyes García ja: Tialtocan, Revista de Fuentes para el Conocimiento de las Culturas Indígenas de México, vol. VI, 1970, b'ede ra 3, pp. 193-212.
"nuna jñäpi juts'i ja n'a ra je̱m'i fädi ra derecho canonigo ko ra tjuju jñämfo̱ ngu ra ""solicitación al administrar el sacramento de la confesión""."	"Nuna ñäpi hutsi ha n'a ra hëmi fädi ra derecho canónigo ko ra t'ut'u ñämfo̱ ngu ra ""solicitación al administrar el sacramento de la confesión""."
nuna m'e̱jna nt'ofo b'e̱tsi ja ra archivo histórico nacional, madrid, documento 165. bi unga mfädi ja ra nt'ofo ya zubi po ra y'ofo ra tjuju ra arthur j. o. anderson et al.: byond the codices: the nahua view of colonial mexico, berkeley, university of california press, 1976, pp. 181-187.	Nuna m’ejna nt’otho b’ets’i ja ra archivo histórico nacional, Madrid, documento 165. Bi unga mfädi ja ra nt’otho ya zubi po ra y’ofo ra t’utju ra Arthur J. O. Anderson et al.: Beyond the Codices: The Nahua View of Colonial Mexico, Berkeley, University of California Press, 1976, pp. 181-187.
nuna nt'ofo b'e̱tsi ja ra archivo general de indias, sevilla, audiencia de méxico 168, bi unga dra fädi po ra miguel león-portilla ja cultura en peligro, méxico, alianza editorial mexicana, 1976, pp. 102-103.	Nuna nt’otho b’ëtsi ha ra Archivo General de Indias, Sevilla, Audiencia de México 168, bi ’ñä nda fädi po ra Miguel León-Portilla ha Cultura en Peligro, México, Alianza Editorial Mexicana, 1976, pp. 102-103.
nuna pika je̱m'i kja te mä b'e̱tsi ja ra archivo general de la nación, nuua m'onda ne kja ja ra nduntji ya jnini, njabu̱ ngu ya nzaya nuni manjyati ne mar'a ya jnini, o̱t'e gi o̱de ra jñä ra mu̱dimejai.	Nuna pika jäme kja te mä b'ëtsi ja ra Archivo General de la Nación, nuwa m'onda ne kja ja ra ndunt'i ya jñeni, njabu ngu ya nzaya nuni manjyati ne mar'a ya jñeni, öthä gi öde ra ñä ra muthimehai.
nuua t'unga yojo ya jmä, kuän'ajmä ya ndeznä ne tjuts'i ja n'a ra k'oi mä mäkjuäni ri ntje̱ui n'a ya dänga ra tju̱ajmä manteb'u̱, nuua pede nu'a gatjo ya ts'otjogi bi y'o̱t'a dega fete ra alvarado.	Nwua t'unga yoho ya hmä, kuän'ahmä ya ndeznä ne txuts'i ja n'a ra k'oi mä mäkjuäni ri ntjehui n'a ya dänga ra txuajmä manteb'u, nwua pede nu'a gatjo ya ts'otxogi bi y'ot'a dega fete ra Alvarado.
nuua ya mu̱di noya ra motolinia, ja ra mu̱di nkoji bi t'o̱t'e ko ra tjuju ra tratado tercero ra dänga b´ede ya mu̱dimejai nuua r´ayo manjyati:	Nwua ya mudi noya ra Motolinia, ja ra mudi nkoji bi t'ot'e ko ra t'ut'u ra tratado tercero ra dänga b'ede ya mudimehai nwua rayo manthiati:
"pa da t'unga mfädi gatjo nu'u̱ bi nkja, n'a di ge'u̱ ko ngu fe̱ti nu'a makjuäni mi joki mi tjutsuabi ya jnei ne ya b'ida. b'u̱i man'a ra mfädi da t'o̱t'a ra nt'udi, nu'a ra tjuju ""fe̱ta nu'a makjuäni bi nja nub'u̱ ra tsokat'o̱tamfeni (teatro de la conquista)""."	"Pa da t'unga mfädi gatho nu'u̱ bi nkya, n'a di ge'u̱ ko ngu fethi nu'a makjuani mi hoki mi tsutsuabi ya jnei ne ya b'ida. B'u̱i man'a ra mfädi da t'o̱t'a ra nt'udi, nu'a ra tjuju ""fetha nu'a makjuani bi nja nub'u̱ ra tsokat'o̱tamfeni (teatro de la conquista)""."
ra europa -mra nxika jai manteb'u̱, mi pe̱tsa n'a ra nxika b'ede-	Ra Europa -mra nxika jä'i manteb'u̱, mi pe̱tsa n'a ra nxika b'ede-.
ra fernando ramírez mä ge nuna jyodi ri nge̱pu̱ jabu̱ kja n'a ra nikja ra san fernando ne ra ermita dige'a ya mártires dige'a san hipólito,	ra Fernando Ramírez mä ge nuna ñudi ri nge̱pü̱ xabu̱ kja n'a ra nikja ra San Fernando ne ra Ermita dige'a ya Mártires dige'a San Hipólito,
"ra fernando de alva ixtlilxóchitl, fernando de, xiii relación: ""ra ñ'eje ya ñämfo̱ ne ra fu̱di ra nkanfri ra evangelio""."	"Ra Fernando de Alva Ixtlilxóchitl, Fernando de, XIII Relación: ""Ra ñ'ɛje ya ñämfo̱ ne ra hudi ra nkänfri ra Evangelio""."
ra kuän'ajma ra n luz jiménez bi juts'i ra fernando horkasitas bi unga mfädi ne bi r'atsi nuña jmä), de porfirio díaz zapata, memoria nábuatl de milpa alta, méxico, unam,, instituto de investigaciones históricas, 1974, p. 105	ra kuän'ajma ra n Luz Jiménez bi juts'i ra Fernando Horcasitas bi unga mfädi ne bi r'atsi nuña jmä), de Porfirio Díaz Zapata, Memoria Náhuatl de Milpa Alta, México, UNAM, Instituto de Investigaciones Históricas, 1974, p. 105
ra raymundo isidro alavez, bi b'u̱i'i nuni ra boxtha chico, san salvador, estado de hidalgo	Ra Raymundo Isidro Alavez, bi b’ui’i nuni ra boxtha Chico, San Salvador, Estado de Hidalgo.
ra jmä ra fundación de santo tomás ajusco, archivo general de la nación, méxico, ramo de tierras vol. 2676, expediente. 4, archivo histórico de la biblioteca nacional de antropología, colección antigua, vol. 254, fojas 259 r.- 260 v.	ra jmä ra fundación de santo tomás ajusco, archivo general de la nación, méxico, ramo de tierras vol. 2676, expediente 4, archivo histórico de la biblioteca nacional de antropología, colección antigua, vol. 254, fojas 259 r.- 260 v.
ra makja mra tjuju ra toribio benavente, motolinia,	ra makxa mra thotho ra toribio benavente, motolinia,
tlauhquechol: ra ts'ints'u̱ xa ntjeni pode ge'a ra flamenco o ra guacamaya, pode ge gatjo ra tje̱nga ts'ints'u̱ ne dänga.	Tlauhquechol: ra ts'ints'u̱ xa ntjeni pode ge'a ra flamenco o ra guacamaya, pode ge gatjo ra tje̱nga ts'ints'u̱ ne dänga.
xkri tso̱ngä ngostji, kja jejni ya 'ñu; nä'ä rí ma nxamädo, ja nä'ä rí ma mäbo̱za. antes de	xkri tso̱ngä ngostji, kja jeni ya ñu; nä'ä ri ma nxamädo, ja nä'ä ri ma mäbo̱za. antes de
ya b'e̱go ne ya b'e̱tri di ge'a nu'a ra dänga ndä ra ndada ra tjuju ra esteban de guzmán ra nzaya di gekua m'onda, ra ndada ra hernando pimentel, ra ndada ra antonio cortés, ra ndada xuua (juan) nuna ra mecoyoacan, ra ndada pedro motecuhzoma, me ma r'a ya kuänmi (firmas).	Ya bꞌe̱go ne ya bꞌe̱tri di geꞌa nuꞌa ra dänga ndä ra ndada ra tjuju ra Esteban de Guzmán ra nzaya di gekua mꞌonda, ra ndada ra Hernando Pimentel, ra ndada ra Antonio Cortés, ra ndada Xuua (Juan) nuna ra Mecoyoacan, ra ndada Pedro Motecuhzoma, me ma rꞌa ya kuänmi (firmas).
ya kuän' ajmä xa tjogi manteb'u̱e ge xa tjäst'i nu'a gatjo ra ntjandi to'o bi b'e̱di ge xa pu̱ngajñä nuna jmä getbu̱ n'ate ya jñäki ge ñä ya nso̱jo̱ jñäki ne xa y'oni nuna nt'ofo neje ja ra jñäki yazi xada kjä'i , ge'a nuna jñäki fadi ja ra jñämfo ko ra tjuju ra sistema braile.	Ya kuänʔ ajmä xa tjogi mantebʔe ge xa tjästʔi nuʔa gatjo ra ntjandi toʔo bi bʔedi ge xa pʔungajñä nuna jmä getbʔu nʔate ya jñäki ge ñä ya nsoʔjoʔ jñäki ne xa yʔoni nuna ntʔofo neje ja ra jñäki yazi xada kjäʔi, geʔa nuna jñäki fadi ja ra jñämfo ko ra tjuju ra sistema braile.
ya r'atsanoya ra sahagán, ndoxkjua k'oi florentino, lib. xii, caps. xxix-xli (versión de ángel ma. garibay k.).	Ya räts’ano ra Sahagún, ndoxkjuä k’oi Florentino, lib. XII, caps. XXIX-XLI (versión de Ángel Ma. Garibay K.).
despwés ya desde k'a ra momento ya k'a ya jíngi bénya'wi já té bimáju̱ k'a ra charroya'wi	después ya desde k’ä ra momento ya k’ä ya hingi béñäwi ja te bimáhü k’ä ra charroyäwi
despwés ya xo bimu̱fí pe xo diario diario bu̱ nchúi mitsu̱ k'a ra charro mi'óbí k'a ra mikwála	después ya xo bimumfi pe xo diario diario bu nt'ui mits'u k'a ra charro mi'obi k'a ra mikwala
goparejájé primero 'á k'a ra parte ánk'ú dínant'í	Gopadejähe primero 'ä k'a ra parte 'ñäñk'u dínandi.
i asta fecha pues ignoro mucho pero másk'ŭ mäkjámá más ndímáignorajéwi	I hñäki fecha pues ignoro mucho pero más k’ŭ mä kjámá más ndí má ignora jéwi.
indu̱odiagí bastante	Ñundu̱diagi bastante
inga se̱je̱ ra nntjandi ra manjyati ne ra portuguesa neje ra francesa, inglesa, alemana e italiana,	Inga seje ra nthe̱thi ra manthe̱ti ne ra portuguesa neje ra francesa, inglesa, alemana e italiana,
k'a mädämé para ke mantenigíjé dígotjó mäbäjtsí pues ni modo dísufréjé	K'a mädämä para ke mantenigíjä dígotho mäbätsi pues ni modo dísufréjä.
kómá'u̱té ya fuente níjí	kómá'ute ya fuente ñuji
ne bi unbabi nduntji ya baba, bi enbabi ge mi ne da ñäui ra ndä (emperador) mi b'u̱i nuni manjyati, ne da jäni ra dänga ts'ofo ra evangelio,	Nde bi unbabi ndunt'i ya baba, bi enbabi ge mi nde da ñäwi ra ndä (emperador) mi b'ui nuni manjyathi, nde da jäni ra dänga ts'ofo ra evangelio,
normalmente gójo	ñuhu̱nthe̱ gójo
panteón ga dó	pantheon ga do 
pero de sesenta pantsítjá pa gotjók'ŭ kompletamente xatjó ndímáfădijé	Pero de sesenta pantsitʃa pa gotʃok'u kompletamente xatjo ndímafadije.
pero eso sí binújgí mängŭjé kada ná	Pero eso sí bí nugi mä ngejä kada na.
"po nuya kja'i to'o mi pede ge fädi ko ra tjuju ya ""cronistas de las indias”"	"po nuya kja'i to'o mi pe̱de ge fädi ko ra tjuju ya ""cronistas de las indias"""
pues este kábádá balewa este mínimo siento sinkwenta	Pues este kábádá balewa este mínimo siento sinkwenta
pues nimodo bisufré k'a más ante mäabwelitajé komo mbu̱i enkajoso ra ntsoya	Pues ni modo bi sufre k'a más ante mä abwelitajé komo mbüi enka joso ra ntsoya.
ra nku̱t'i ra juajni ne ya ñ'udi ntjutsi ra agustin yáñez 2da. edición. biblioteca del estudiante universitario, unam, 1950.	Ra nkut’i ra hñuäni ne ya ñ’udi nt’utsi ra Agustin Yáñez 2da. edición. Biblioteca del Estudiante Universitario, UNAM, 1950.
solamente ya riko alkansabi	Solamente ya riko alkansabi
xi ra tí na ta komedór 'á itsí na ta alimento k'a ra ndăni	Xi ra ti na tha komedor 'a itsi na tha alimento k'a ra ndäni.
xo mitajá ra ntsoya mitá sínko pesos ra béjña dos sinkwenta	Jó mi̱thatha ra nts'o̱ya mi̱ta̱ hño̱tho̱ pesos ra béxña dos sinkwenta.
xo takja mä sesenta wik'a takja mä sesenta bitajkíjéya'wik'a	xo̱ tagi ma̱ sesenta wi̱k'a tagi ma̱ sesenta bitajkíjéya'wik'a
á panteón ga dó níjí	a̱ pantheon ga do̱ nthe̱the̱
ñúdigejña dabadijíya' razo''ya' mientra más dandu̱jté	ñudi̱ge̱ña dabadijiya ra̱zo̱ya̱ mientra más dandu̱hte̱
-nu'u̱ dige'u̱ b'u̱i nuni maxey (tolimán ne amealco), dige'u̱ temoaya nuni ra ra jyodi estado de méxico ne mar'a ya jyodi nuni puebla ne veracruz	Ñuhu digehu b’ui nuni maxei (Tolimán ne Amealco), digehu Temoaya nuni ra ra ñudi Estado de México ne mar’a ya ñudi nuni Puebla ne Veracruz.
ne mätajekitjo di kja getbu̱, ra jñäpi ra joel martinez hernández ne ra jotjo tjuajmä ra natalio hernández xocoyotzin, nuya yojo ya xajnate ri ñ'eje ya y'u̱ dige'u̱ ya ndeznä.	Ne mät'äjeki̱tho di kja getbu̱, ra jñäpi ra Joel Martinez Hernández ne ra hño tjuäjmä ra Natalio Hernández Xocoyotzin, nuya yoho ya xajnate ri ñ'äjä ya y'u̱ dige'u̱ ya ndeznä.
"-n'ate pa n'a ra zänä de ra r'e̱t'a ma jñäto ""zänä"" mi zo̱ta ya munts'i ya n'ate ya pa ge mi joki ra xihuitl o ""ra m'ede ra kje̱ya"""	N’ate pa n’a ra zänä de ra r’ët’a ma ñäto “zänä” mi zotha ya mints’i ya n’ate ya pa ge mi joki ra xihuitl o “ra m’ede ra këya”
bi ma di gepu̱ jam''u̱ ra ngo pa da ts'itje ya it'adeje (Tlahuano) ba po̱ni nubu̱ tlapechhuan. mra ngo ra izcalli.	Bi ma di hñepu̱ ham'u̱ ra ngo pa da ts'itje ya it'adeje (Tlahuano) ba po̱ni nubu̱ tlapechhuan. Mra ngo ra izcalli.
bi mu̱di da jyoka ya t'u̱kats'u̱fabo̱kja. ge'a ra ntujni bi nkja nuni Coyohuehuetzin ne ma gojo ba nkja.	Bi mudi da yoka ya t'ukats'ufabokjä. Ge'a ra nt'uni bi nkä nuni Coyohuehuetzin ne ma goho ba nkä.
bri tjo ra cuauhnochtli, ra gabida tlacatecco, ra cuapan, ra gabida huitznáhuac, ra makja Amantlan, ne ra makja tlacopan.	B’ri t’yo ra kuawnoxt’i, ra gabida tlakateko, ra kwapan, ra gabida witsnawaka, ra makxa Amantlan, ne ra makxa tlakopan.
bri ts'u̱tuabi ja ra y'u̱ga n'a ra nto̱de dega t'u̱ka joga do dega chalchihuite: made mi juts'i n'a ra tsant'i dega k'astabokja.	B'ri ts'utuabi ha ra y'uga n'a ra nt'ode dega t'uka hoga do dega chalchihuite: made mi huts'i n'a ra tsant'i dega k'astabokha.
Castañeda, ra t'u ra Aquiyahualcatecuhtli, m ra ndä nuni tlaxcala.	Castañeda, ra tu̱ ra Akuiyahualkatekuhtli, m ra ndä nuni Tlaxcala.
Coaíhuitl mra gabida ndeznä nuya mapa digeá ra t'o̱t'ats' okamfeni.	Koaíhuitl mra habida ntsenä nuya mapa digea ra t'ot'ats' okamfeni.
di gepu̱ ba koi pa nuni ra Xochimilco. nubu̱ ba tu ya kjä'i ya metlatelolco	Di hñepu̱ ba ko'i pa nuni ra Xochimilco. Nu̱bu̱ ba tu ya kjä'i ya Metlatelolco.
ebu̱ ba eje man'aki ba te̱nga ra t'o̱jo̱ ra tjuju ra Citlaltépec. Tlacopan, nubia ba o̱t'ra b'u̱i ja ra ndo̱m'ijmu.	Ebu̱ ba eje man'aki ba te̱nga ra t'o̱jo̱ ra tjuju ra Citlaltépec. Tlacopan, nuvia ba o̱t'ra b'u̱i ja ra ndo̱m'ijmu.
ebu̱ bi dädi ra Cihuacóatl:	Ebo̱ bi dädi ra Cihuacóatl:
ebu̱ bi ñä ra Cuauhtémoc bi xipabi ra Cihuacóatl:	Ebu̱ bi ñä ra Kuauhtémoc bi xipabi ra Siwakóatl:
gojo n'ate ya pa ne ebu̱ bi yopa bo̱ni pa di mani ra Huaxtepec, ra Cuauhnahuac (Cuernavaca).	Go̱tho n’ate ya pa ne ebu̱ bi yopa bo̱ni pa di mani ra Huaxtepec, ra Cuauhnahuac (Cuernavaca).
gue dá nhuat'i mbo kja ra ximjai,	güi dá ñwät'i mbo kja ra ximhai,
i nte ra nge'a, ya jmä juts'i ja ra ndäxkjua k'oi ra códice ra ramírez uni nuna b'e̱de mä makjuäni ngu mä ra ntje̱ka b'ede ne ra ndädi nu'a ra nänä mra tjuju ra yacotzin, ra nänä ra ixtlilxóchitl,	I nthé ra nge'a, ya jä́ mä juts'i ja ra ndäxkjua k'oi ra códice ra Ramírez uni nuna b'ede mä makjuäni ngu mä ra nt'eka b'ede ne ra ndädi nu'a ra nänä mra tjuju ra Yacotzin, ra nänä ra Ixtlilxóchitl.
inda jyo ko ra ndäxjua ixtlilxóchtil, ra dada ra Nezahualcóyotl ni ko ra fernando de alva ixtlilxóchitl.	'nda jyo ko ra ndäxjua Ixtlilxóchitl, ra dada ra Nezahualcóyotl ni ko ra Fernando de Alva Ixtlilxóchitl.
k o ya bu̱' bai, ko ya makahuai,	Gó yo ya bu̱' mbai, ko yo makahuai,
mi fudi da t'axka ra xudi ba ts'i, bri tját'a ja n'a ra za mi b'ai ja ra ngu ra Ahuizotzin nuni ra Acatliyacapan.	Mi fudi da t’axka ra xudi ba ts’i, bri tját’a ja n’a ra za mi b’á’i ja ra ngu ra Ahuizotzin nuni ra Acatliyacapan.
mi gu̱t'a ra ñ'u̱ n'a ra makja ge'a mra b'e̱fi mi zu nu'a ra mäka jai mra tjuju ra Yohualichan.	Mi ngúthä ra ñ'ú nthä ra makxa geä mra b'efi mi zu nu'a ra mäka häi mra t'ot'u ra Yohualichan.
mi y'o y'oua, mi tuts'i ya bu̱'bai dega za, ne r'a mi jä dega bo̱ja ne ya mahuai.	Mi y'o y'owa, mi t'utsi ya bu'bai dega za, ne ra mi jä dega boja ne ya mahuai.
mra ngu ra Aztautzin ge'a mi kja getbu̱ nuni ra Amáxac.	Mra ngu ra Aztawts'i ge'a mi kja get'bu̱ nuni ra Amáxak.
n'a ra jyo ne man'a bi xokuabi ra debi. ra Cuauhtemoctzin bri xokuabi ra debi ge'a se̱je̱.	N’a ra ñu̱hmu̱ ne man’a bi xoku̱hpi ra te̱pi. Ra Cuauhtemoctzin bri xoku̱hpi ra te̱pi ge̱’a se̱je̱.
ne m'e̱fa bi ma xki jäki ya je dega magabi, ñätsi bi ntsaya ra mahuai ne ra bu̱'bai, bri nkjonda ya bo̱najmu nuni Acachinanco.	Ne m’efa bi ma xki jäki ya hñäki ya je dega magabi, ñätsi bi ntsaya ra mahuai ne ra bu'bai, bri nk’onda ya bo'najmu nuni Acachinanco.
ne nkjabu̱ bri t'ot'e neje ko mar'a ya bo̱najmu mi pe̱tsi ra t'u̱ka tsu̱tui ja ya t'u̱ka jnini, nuyu̱ to'o mi b'e̱pi da t'o̱t'e ngu nuni Xalapan, Tlaxcalan, Tehuantepec, Oaxaca neje mar'a ya bo̱najmu mar'a ya t'u̱ka jnini jabu̱ bi guat'i ya nduste, ya dumantjuju dega k'astaboja, ge ya tjuju ya kristiano [...]	Ne nkjabu̱ bri t'ot'e neje ko mar'a ya bo̱najmu mi pe̱tsi ra t'u̱ka tsu̱tui ja ya t'u̱ka jnini, nuyu̱ to'o mi b'e̱pi da t'o̱t'e ngu nuni Xalapan, Tlaxcalan, Tehuantepec, Oaxaca neje mar'a ya bo̱najmu mar'a ya t'u̱ka jnini jabu̱ bi guat'i ya nduste, ya dumantjuju dega k'astaboja, ge ya tjuju ya kristiano [...]
ne nu'a ri däme, pu̱ ñ'a'i, nugi ga ma ga tsogi'i nuni Cuetlachcoapan [n'a ra jnini nuni puebla],	Ne nu'a ri däme, po̱ ña'i, nugi ga ma ga tsogi'i nuni Cuetlachcoapan [ña ra jnini nuni Puebla],
ne nu'u̱ bi mani dra ts'okat'o̱t'amfeni nuni Michoacán, Xalisco, Culhuacan ne nuni neje Pánuco, ne nuni Oaxaca, Tehuantepec ne Guatemala, ne nuua ra r'ayo majyati, nub'u̱ bri t'o̱t'a ra mabagi pa dra uadi dra t'o̱t'a nu'a ra ts'okat'o̱t'amfeni inda tsogije se̱je̱.	Nde nu'u̱ bi mani ra ts'okat'o̱t'amfeni nuni Michoacán, Xalisco, Culhuacan ne nuni neje Pánuco, ne nuni Oaxaca, Tehuantepec ne Guatemala, ne nuwa ra r'ayo majyati, nu'b'u̱ bri t'o̱t'a ra mabagi pa ra uadi ra t'o̱t'a nuwa ra ts'okat'o̱t'amfeni nda tsogije se̱je̱.
nejege'a ra ngätsi. mi jä ya mpe̱fi dega mabagi,ya nkjom'a te ne ya fu̱nbo̱kja, inte ma mahuai mi jä ni ge'a ya bu'bai.	Nejege'a ra ngätsi. Mi jä ya mpefi dega mabagi, ya nkjom'a te ne ya funbokja, inte ma mahuai mi jä ni ge'a ya bu'bai.
njabu̱ bi bo̱nga dega xui. mra ngo nub'u̱ ra Tecuílhuitl bi bo̱nga: nub'u̱ bi kja ya du ja ra r'ani ra deje ya u̱erna.	ñäbu̱ bi mbonga dega xui. mra ngo nu'b'u̱ ra Tecuílhuitl bi mbonga: nu'b'u̱ bi kja ya du ja ra r'ani ra dexe ya u̱erna.
nub'u̱ bi tjandi ra Tzihuacpopoca, bi t'ena:	Nub'u̱ bi txandi ra Tzihuacpopoca, bi t'ena:
nub'u̱ ya ñämfo̱ bi jandi ge xa ñ'eje nubu̱ da tsu̱di, ge mi tekuabi ra nest'iji, m'estjo bi munts'i bi miji ya mahuai.	Nub'ú ya ñämfo̱ bi jandi ge xa ñ'ejë nubu̱ da tsu̱di, ge mi tekuabi ra nest'iji, m'estyo bi munts'i bi miji ya mahuai.
nuna kjä'i inbi tsa bi tjädi makjuäni nu'a ra nt'ani. ingra nge'a nuya pa bi jneki n'a ra jyoya jä'i ra macehual (hombre de pueblo),	Nuna kä’i inbi tsa bi tädi makyuäni nu’a ra nt’ani. Ingra nge’a nuya pa bi jneki n’a ra yoya jä’i ra masehual (hombre de pueblo),
nuna nte̱nga b'ede ja bri jat'i ra Tzihuacpopocatzin, bi o̱t'e da tjogi ge'a ra ts'e̱y'e̱jmu. inbi bo̱nga nuna nt'o̱t'e bi tsu̱diju̱ ko ma r'a ya b'e̱jni. ma ra ya ñ'ete inbi jopi da kju̱ man'aki ra ñ'u nuya ts'okate. pe nuya inbi joki ra b'ai.	Nuna nte̱nga b'ede ha bri hat'i ra Tzihuacpopocatzin, bi o̱t'e da tjogi ge'a ra ts'e̱y'e̱jmu. Inbi bo̱nga nuna nt'o̱t'e bi tsu̱diju̱ ko ma r'a ya b'e̱jni. Ma ra ya ñ'ete inbi jopi da kju̱ man'aki ra ñ'u nuya ts'okate. Pe nuya inbi joki ra b'ai.
nuua di udije ra jñäpi bi nto̱t'e bi nkja ra agosto ra kje̱ya 1595, n'a ra kjä'i mra tjuju ra miguel Hernández, ra me Chiyauhtzinco,	Nwua di hñudi ra jñäpi bi nt'ot'e bi nkja ra agosto ra kje̱ya 1595, n'a ra kjä'i mra t'ot'u ra Miguel Hernández, ra me Chiyauhtzinco,
nuya bo̱najmu ya mem'onda ñätsi bi ñäui ra Cihuacóatl Tlacotzin m'estjo bi tjädi:	Nuya bo̱najmu ya mem’onda ñätsi bi ñäwi ra Cihuacóatl Tlacotzin m’estjo bi tjädi:
ra Tlacatécatl mra me Cuauhtitlan ne ra bktri ra mbot'a ngu bri kjapi ya tsat'yo bi zi.	ra Tlakatékal mra me Kuauhtitlan ne ra büktri ra mbotha ngu bri kjapi ya tsatyo bi zi.
ra doy'e̱ pajni xki njom'i ko ya chalchihuite.	Ra doye̱ pahni xki ñomi ko ya chalchihuite.
ra mu̱di ra Cuauhtémoc, ra jmu ra bondo, ra nyojo ra tlatsotzin, ra Cihuacóatl ra njñu ra oquiztzin, ra bo̱najmu ja ra nini ra aztsapotzaltso Mexicapan, ra ngojo ra panitzin, ra bo̱najmu nuni ra Ecatepec,	ra mudi ra Cuauhtémoc, ra jmu ra bondo, ra ñoju ra tlatsotzin, ra Cihuacóatl ra ñu ra oquiztzin, ra bonajmu ja ra nini ra aztsapotzaltso Mexicapan, ra ngoju ra panitzin, ra bonajmu nuni ra Ecatepec,
ra mu̱di ra pa mi o̱t'e ra ngo ra mäkime ra u, ra tjuju ra Huixtocihuatl	ra mudi ra pa mi othi ra ngo ra mäkime ra u, ra t'ut'u ra Huixtocihuatl
ra nge'a bi mu̱ni ko ra mahuai ja ra xu̱tja nu'a to'o bi umbabi ra kji.	Rä nge’ä bi muni ko rä mahua’i ja rä xut’ä nu’a to’o bi umbabi rä k’í.
ra nyojo, bi tjo ra ndä ra Nauhtla, mra tjuju ra Cohualpopocatzin.	Ra ñoju, bi t'yo ra ndä ra Nauhtla, mra t'juyu ra Cohualpopocatzin.
unga ya ngue̱nda te ra ts'omu̱i mi bu̱'i ne mi kjapi da ntso̱m'i nuya macehualtin, nkjabu̱ mi tjutuabi ya kjä'i mi b'u̱i te ma za	'unga ya ngüenda te ra ts'oni mi b'ui ne mi kjapi da nts'oni nuya masehualtin, nkjabu mi chuchuabi ya kä'i mi b'ui te ma za
xib'u̱ bri fádi ge nuya je mi kja nuni ra Cuauhchichilco, ja Xaltocan; ge mi pttsi ya ndá.	Xib'u̱ bri fádi ge nuya hñäki mi kja nuni ra Cuauhchichilco, ja Xaltocan; ge mi pttsi ya ndá.
xki mbo̱ni nubu̱ ra jyodi ra Cuehuecatitlan,	xki mbo̱ni nubu̱ ra ñudi ra Cuehuecatitlan,
xki tjete ra ixtlilxóchitl ne ra ku ra Cohuanacotzin ko ya je dega dänga ndä bi mu̱di da jäni ra joga ts'ofo ya evangelio,	Xki tjete ra Ixtlilxóchitl ne ra ku ra Cohuanacotzin ko ya hñäki dega dänga ndä bi mu̱di da jäni ra hoga ts'ofo ya evangelio.
ya dänga ñu̱ni nsafi, ya nsafi, ya mahuai, jangu nu'u̱ gatjo xki tagi mbo ja ra jñe.	Ya dänga ñu̱ni nsafi, ya nsafi, ya mahuai, jangu nu'u̱ gatjo xki tagi mbo ja ra jñe.
bi o̱tuabi nu'a ra makja xki nk'ojni mra tjuju ra alonso ruiz, ge mi y'o nuni juamuxtitan (Huamuxtitlan) nuni ra jyodi guerrero.	Bi othoabi nu'a ra makxa xki nk'ojni mra tjuju ra Alonso Ruiz, ge mi y'o nuni Juamuxtitán (Huamuxtitlán) nuni ra jyodi Guerrero.
di pädi xajño nuna b'e̱fi neje yojo to'o di pädi da mpe̱fi da y'este nuya joga do majye̱gi ya xito, mra tjuju ra ambetz'ihuay.	Di pädi xajño nuna b'efi neje yojo to'o di pädi da mpefi da y'este nuya joga do majyegi ya xito, mra tjuju ra ambetz'ihuay.
dra tjoki ra nto̱de, ra ketzal dra b'e̱ nuni Coyohuacan.	Ra txoki ra nt’ot’e, ra k’etsal ra b’ë nuni Coyohuacan.
e mi r'ani dega xui ra Cihuacóatl g'ea mi zoni ne mı mafi.	E mi r’ani dega xui ra Cihuacóatl g’ä mi zoni ne mi mafi.
ebu̱ bi gäi jabu̱ mi to̱ge ebu̱ bi yopa ma ja ra jnini ra Cuetaxtlan,	ʔe̱hü bi gäi häbu̱ mi to̱ge ʔe̱hü bi yopa ma ja ra jñäni ra Cuetaxtlan,
ge'a ra mu̱di ra tjuju ra Hernando, ra nge'a nkjabu̱ mra tjuju ra takjä ra Cortés neje nkjabu̱ mra tjuju ra ndä Católico ne ra ku ra Cohuanacotzin bi tjutuabi ra Pedro po ra Pedro Alvarado ra nge'a ra takjä,	Ge’a ra mudi ra t’ot’u ra Hernando, ra nge’a nkjabu mra t’ot’u ra takxä ra Cortés neje nkjabu mra t’ot’u ra ndä Católico ne ra ku ra Cohuanacotzin bi t’ot’obi ra Pedro po ra Pedro Alvarado ra nge’a ra takxä.
ma n'a mi b'ai nuni teotletso, jabu̱ ra ñ'u̱ pa manjuäntjo pa da zo̱ni nuni ra peñón (Tepetzinco).	Ma n'a mi b'ai nuni teotletso, jabu̱ ra ñ'u̱ pa manjuäntjo pa da zo̱ni nuni ra peñón (Tepetzinco).
"mi tso̱jo̱ getbu̱ ra fu̱nga t'o̱jo̱, jabu̱ mi tjutuabi ""takjón ra nxu̱ni, nkjabu̱ bi jutuabi ya ndeznä ya b'e̱jnanoya bi pe̱jni ra ts'e̱y'e̱jmu, mi gu̱t'a ra ñ'u ra Tzihuacpopocatzin, bi bo̱nga ja ra ñ'u."	"Mi tso̱ho̱ gethbu̱ ra fu̱nga t'o̱ho̱, hñabu̱ mi thuthuabi ""takjón ra nxu̱ni, nthabu̱ bi huthuabi ya ndeznä ya b'e̱hnanoya bi pe̱hni ra ts'e̱y'e̱hmu, mi gu̱t'a ra ñ'u ra Tzihuacpopocatzin, bi bo̱nga ha ra ñ'u."
mra ku ra Cacamatzin mra bo̱najmu nuni Tetzcoco mri ñ'oui va kjä'i mi y'o mpaja.	Mra ku ra Cacamatzin mra bo̱najmu nuni Tetzcoco mri ñ'oi va kä'i mi y'o mpaha.
n'a ra nto̱de dega chalchihuite, xi m'et'e dega ze̱ka do, neje mi pe̱tsi n'a ra tsant'i de ga k'astabokja.	N’a ra nt’ode dega chalchihuite, xi m’et’e dega zeka do, neje mi pëtsi n’a ra ts’andi dega k’astabokja.
ne nduntji ya ambetz'ihuay ne mar'a joga do mi pe̱tsi ra mu'ui:	Ne ndunt'i ya ambets'ihüi ne mar'a hoga do mi pëtsi ra mïhï.
neje n'a ya tje̱stji dega mboťahuaido.	Neje n’a ya txesthi dega mbo̱thahuaido.
nuna bi o̱t'a ra ntso̱m'i ra nge'a neje nuya ya b'e̱datsi bi tsini ko ra Cortés ne ra Cohuanacotzin ne ra ixtlilxóchitl xki nsofo pa ra ixtlilxóchitl da gu̱ka ya kjä'i ge mi zu ya jyodi, nkjabu̱ mi pe̱jna akjuä da t'o̱t'e.	Nuna bi o̱t'a ra ntso̱m'i ra nge'a neje nuya ya b'e̱datsi bi tsini ko ra Cortés ne ra Cohuanacotzin ne ra Ixtlilxóchitl xki nsofo pa ra Ixtlilxóchitl da gu̱ka ya kjä'i ge mi zu ya jyodi, nkjabu̱ mi pe̱jna akjuä da t'o̱t'e.
nuna nt'o̱t'e bi ntjandi xa nts'ogi njabu̱ bri tjutuabi, bi ena ge mra nzu̱te ko ma m'u̱jai ra nzu̱te ne mi tjutsuabi ko ya mpe̱bi dega mabagì, jabu̱ jmä ge n'a di ge'u̱ bi y'e̱nga n'a ra do, ko nge'a bi jyo, nu'u̱ mar'a ya b'e̱go ge mä ge nu'u̱ se̱je̱ ya ñämfo̱ bi jyo bi mu̱tu'a n'a ra mahuai ja ri ngati bi mu̱tuabi n'a ra nzu̱ni.	Nuna nt’ot’e bi nt’andi xa nts’ogi njabu bri t’utuabi, bi ena ge mra nzute ko ma m’ujai ra nzute ne mi t’utsuabi ko ya mpefi dega mabagì, jabu jmä ge n’a di ge’u bi y’ënga n’a ra do, ko nge’a bi jyo, nu’u mar’a ya b’ëgo ge mä ge nu’u sëjë ya ñämfo bi jyo bi mutu’a n’a ra mahuai ja ri ngati bi mutuabi n’a ra nzuni.
ra Cuauhtémoc, Tlacotzin, ra Cihuacóatl, Oquiztzin, Panitzin, Motelhuihtzin; nuna bi sofo ra tsortés nuni Coyoacan, nu'u̱ to'o mi pädi yojo ya jñäki ngu'a ra jerónimo aguilar ra malintzin.	Ra Cuauhtémoc, Tlacotzin, ra Cihuacóatl, Oquiztzin, Panitzin, Motelhuihtzin; nuna bi sofo ra tsortés nuni Coyoacan, nu'u̱ to'o mi pädi yojo ya jñäki ngu'a ra Jerónimo Aguilar ra Malintzin.
t'ena ge ya macehual [ya kjä'i b'u̱i ja ra jyoya]	T'ena ge ya ma̱hñuts'i [ya kä'i b'ui ja ra ñoya]
"xki tjokuabi nuya jotjo ts'ints'u̱ mra tjuju ra ""tlauhquecho"" ne “tzinitzcan zacuan"","	"Xki thokuabi nuya hothjo ts'ints'u̱ mra thuthu ra ""tlauhquecho"" ne “tzinitzcan zacuan”,"
-¿te be'a gi mä nu'i Cihuacóatl?	-¿Te bädi gi ma nu'i Cihuacóatl?
bi k'ajni ko ya dänga ñuni nzafi ne bi tjetse ko ya makahuai nuya otomi geb'u̱ bi japi bi b'e̱di, bi mä nuyu̱:	Bi k’ajni ko ya dänga ñuni nzäfi ne bi tjetse ko ya makahuai nuya hñätho ge’bu̱ bi japi bi b’e̱di, bi mä ñu̱hü:
da tjuts'i ya nkjot'ijñä ( )	Da txuts'i ya nkjot'ijñä.
da umbabije te da zi, da kjapabije nduntji ma zu.	Ra umbabihe te ra zi, ra kyapabihe ndunt'i ma zu.
ebu̱ bi mä nuna b'e̱fi xa tjoki xajño bi kjohya ra ts'e̱y'e̱jmu.	Ebu̱ bi mä nuna b'e̱fi xa txoki xañu bi kjohya ra ts'e̱y'e̱jmu.
"fernando alva ixtlilxóchitl, xiii nkjändajmä ""ra ñ'eje ya ñämfo̱ ne ra mu̱di ra joga ts'ofo ra evangelio."""	"Fernando Alva Ixtlilxóchitl, XIII nkjändajmä ""ra ñ'ëje ya ñämfo̱ ne ra mfo̱di ra hoga ts'ofo ra evangelio."""
ga kjuatiju̱ nu'a juts'i nkjani, ya ts'ojä'i, ra carranza, ge xa o̱t'a ya ts'okuate pa gekagiju̱; ga o̱t'e da nkja ra ts'e̱di ma munts' ne njabu̱ ga tsu̱diju̱ da nkja nu'a ra joga tsu̱tui, da nkja ra jai, ra jñegi ne ra joga ts'u̱tui;	Ga kjuäti nu'a hñuts'i nkäni, ya ts'oyä'i, ra karransa, ge xa o̱t'a ya ts'okuäti pa gekägi; ga o̱t'e da nkä ra ts'edi ma mints'i ne ñäbu ga tsu̱di da nkä nu'a ra hoga tsu̱tui, da nkä ra häi, ra ñägi ne ra hoga ts'u̱tui;
gatjo ya jyoyakjä'i mi b'u̱i ja ra jnini bi jandi.	Gatjo ya ñ'oyakjä'i mi b'ui ya ra ñ'eni bi yandi.
ja bi jäni ra ñ'udi, ma kjä'iju̱ bi ent'i gatjo majye̱gi nuya nzu̱te	Xa bi jäni ra ñ'udi, ma kjä'i̱ju̱ bi enti ga̱tho majä̱gi nuya nzute.
ja n'aa nza̱tjo xudi ra pale berto, bi bo̱ni nda jyonga te nda nzimxidi ngetjo nda zi ya jme jyaxtjo mi u̱xa ya u, ua ngu mi nzäi mi nkajui yá jme nuya chukju̱ xa jogi ja nuya 'bomuja̱i nts'ät'i, nt'o̱kuä;	Xa nää nzätjo xudi ra pale Berto, bi bóni nda yonga te nda nzimxidi nge̱tjo nda zi ya jme jyaxtjo mi uxa ya u, ua ngu mi nzäi mi nkajui yá jme nuya chukju̱ xa jogi ja nuya 'bomuja̱i nts'ät'i, nt'o̱kuä.
ja nubia di ndäki, di ndändiñäjmu, di ma ga ts'u̱tsa'i ri y'e, ga ndäne'i ra nge'a nu'a'i ma makjaje, ra bartolomé lópez, nub'u̱ mi nkjuäni ma b'e̱jña inbi nkjuäni ja nubu̱ mi xaxi pa da o̱t'a ya tso̱mfen	Xa nuvia di nt'äki, di nt'ändiäjmu, di ma ga ts'u̱tsä'i ri y'e, ga nt'äne'i ra nge'a nu'a'i ma makxaje, ra Bartolomé López, nu'b'u̱ mi nkjuäni ma b'e̱xña inbi nkjuäni xa nu'b'u̱ mi xaxi pa da o̱t'a ya tsö̱mfen.
ja ya t'u̱ka ze̱ki tjuts'i n'a tu̱kitjo nuna tjogi ge bi juxa ra fernando alva ixtlilxóchitl, nu'a b'e̱tsi ra xiiii nkjondajmä.	Xa ya t'uka zeki ñuts'i n'a tukitjo nuna ñogi ge bi juxa ra Fernando Alva Ixtlilxóchitl, nu'a b'ëtsi ra xiiii ñkondaxmä.
jabu̱ ga kju̱he nuyu̱ (ya tenochcas) te gi joniju̱?	Yabu̱ ga kju̱he nuyu̱ (ya tenochcas) te gi joniju̱?
jam'u̱ gatjo ya kjuän'ajmä ge nuua xa ze̱ti ri ñ'eje dige'a ya noya ya mu̱dimejai ja ra jñä ya ndeznä, nuna tjuju ri uni inga se̱je̱ ra n'atsanoya pa da fädi ra jñämfo̱, ingi ri me̱udi dige'a ra jmä fu̱oti dige'a nuna ra jñäki ra netzajualtsoyotl. ne ra cuauhtémoc.	ham'u̱ gattho ya kjuän'ajmähe ge nuwa ha ze̱ti ri ñ'eje digehe ya noya ya mu̱dimehai ha ra jñä ya ndeznä, nuna tjuju ri uni inga se̱je̱ ra n'atsanoya pa da fädi ra jñämfo̱, ingi ri me̱udi digehe ra jmä fu̱oti digehe nuna ra jñäki ra netzajualtsoyotl. ne ra cuauhtémoc.
mi jneki ngu ma kjä'iju̱ ngabu̱ mri jneki.	Mi hñäki ngu ma kä’i̱ju̱ ngabu̱ mri hñäki.
nduntji bri kjojya, bri tjuxpabi gatjo nu'a mi o̱t'abi ra b'edi, ko nge'u̱ bi m'u̱i ne mi t'umbabi ya t'ixu:	Ndunt'i hñäki k'oiya, hñäki txuxpabi gato nu'a mi o̱t'abi ra b'edi, ko nge'u̱ bi m'u̱i ne mi t'umbabi ya t'ixu:
ngu mra me̱ti, nu'a r'a hyodi, jabu mi y'o, n'a ngu n'a mi kjohya mi mfe̱m'a xinxi xi mi kjohya ya ndäte, mi tjede n'a ngu n'a mi jñu̱fi ne mi fe̱m'a ya xinxi: xi mi b'u̱i mpaja.	Ngu mra me̱ti, nu'a r'a hyodi, jabu mi y'o, n'a ngu n'a mi kjohya mi mfe̱m'a xinxi xi mi kjohya ya ndäte, mi tjede n'a ngu n'a mi jñu̱fi ne mi fe̱m'a ya xinxi: xi mi b'u̱i mpaja.
nkjabu̱ ri ñ'eje ya kje̱ya inda m'e̱di, inda mpumfri, ga nzäi ga pe̱tsi nugagiju̱ ja ma mfeniju̱, ga pe̱tsi nugagiju̱, ra bätsi dige'u̱, ya b'e̱to, ya ntsaniku, ya mbänga b'e̱to ne to'o dra ñ'epu̱, to'o majye̱gigiju̱, ma kjiju̱, ya ku̱ju̱.	nkjabu̱ ri ñäjä ya kje̱ya nda mädi, nda mpumfri, ga nzäi ga pe̱tsi nugagiju̱ ja ma mfeniju̱, ga pe̱tsi nugagiju̱, ra bätsi dige'u̱, ya b'e̱to, ya ntsaniku, ya mbänga b'e̱to ne to'o ra ñäpu̱, to'o majye̱gigiju̱, ma kjiju̱, ya ku̱ju̱.
nu xä otj'u̱, ma gä ñ'kjäju̱	Ñu xä otj'u̱, ma ga ñ'kjäju̱.
nuga̱ xi di ne'i, jindi pädi jankja...	Nuga̱ xi di ne’i, hñäki pädi ñäñk’a...
num'u̱ di kjojyaju̱, nkueju̱, nts'o̱miju̱, tsuju ne pa da t'o̱xkäju̱ di jojñu̱ nu ya nt'u̱i xi di 'yooju̱ (¡!). nuya da nt'ot'i ko ra dänt'ot'í	Num'ú di kyojyayu̱, nkweju̱, nts'o̱miju̱, tsuju̱ ne pa da t'o̱xkäyu̱ di hñoju̱ nu ya nt'u̱i xi di 'yooju̱ (¡!). Nuya da nt'ot'i ko ra dänt'ot'í.
nuna bi kjojya ja ra mabagi,	nuna bi xojya ja ra mabagi,
nuya jñu o gojoya pa bi b'u̱i nubu̱ bi xitsuabi ra kjäpadeje nduntji ya kjä'i, ngu xa t'ena.	Nuya ñuhu o gohoya pa bi b’ui nubu bi xitsuabi ra kjäpadeje ndunt’i ya kjä’i, ngu xa t’ena.
nuya tsat'io mi b'et'o, mi gu̱t'a ra ñ'u, mi teni, ya xiñu mi kju̱ts'i pa mañä, xi mi päjä gatjo mi jandi mi nest'iji: mi tu̱ta ya kjijni	Nuya tsät’i hñä b’ët’o, hñä güt’a ra ñ’u, hñä teni, ya xiñu hñä küt’i pa mañä, xi hñä päjä gatjo hñä handi hñä nest’i: hñä t’uta ya k’ijni.
pe, nu'i ndada nu'i ma t'ek'ei ra makja, nub'u̱ nu'i ingi zugagije, ¿jankja, nuua, ra jyo di ge'a, ga tsogi nubu̱ [nu'a ma b'e̱jña]?	Pe nu’i ndada nu’i ma t’ɛk’ɛi ra makxa, nub’ui nu’i ingi zugagixe, ¿jankxa, nuwa, ra jyo di ge’a, ga tsogi nub’ui nu’a ma b’ɛjña?
r'a ya kjä'i mi b'u̱i ja ra ngumi kja nunu ja ra jnini ri mankjuäntjo pa da tsoni nubu̱ ra amáxac,	r'a ya kä'i mi b'ui ya ra ngumi kja nunu ya ra ñuni ri mankjuäntjo pa da tsoni nubu ra amáxac,
ra nge'a di o̱t'a nuna noya ra ts'u̱tui ne gatjo to'o da guat'a ja ma jyoje, nu'u̱ to'o da ne, da me̱tsi n'a ra joga m'u̱i ne da m'u̱i mankjuäntjä. ja nubu̱ xa mabu̱ ma noya ge di pe̱tsi ra tsa, dega joga kjä'i ne dega jogat'o̱t'antujni	Ra nge’a di o̱t’a nuna noya ra ts’u̱tui ne gatjo to’o da guat’a ja ma jyoje, nu’u̱ to’o da ne, da me̱tsi n’a ra joga m’u̱i ne da m’u̱i manxjuäntjä. Ja nubu̱ xa mabu̱ ma noya ge di pe̱tsi ra tsa, dega joga xjä’i ne dega jogat’o̱t’ant’ujni.
ra ngejna nuna pa bi ma n'a ra ñ'u mankjuäntjo.	Rä ngejna nuna pa bi ma n’a rä ñ’uhu mankjuänt’o.
ra njñu ne ra ngästsi ra b'ist'ofo di juts'iju̱ ja nuna ze̱ki b'ist'ofo, ri ñ'eje ra vii nkjondajmä ra chimalpain,	ra ñuhu ne ra ngästsi ra b'ist'ofo di hñuts'i̱hü ya nuna zäki b'ist'ofo, ri ñ'äje ra bi nxondaxmä ra chimalpain,
ra ntjädi ra cuitlahuacatzin bi ena ge ina da o̱t'e nuya bi b'e̱pabi ya nso̱jo̱kjä'i,	ra ntjädi ra cuitlahuacatzin bi ena ge ina da o̱t'e nuya bi b'e̱pabi ya nzokjä'i.
ra nyojo nu'a mi zu ra tepoztlan; ra njñu ra me tizatlan, ra nkjojo mi ñ'eje nuni huehuetlan ne ra nku̱ta mra dänga mictlan.	Ra ñoju̱ nu'a mi zu ra Tepozotlán; ra ñ'ño ra me Tizatlán, ra ñ'jojo mi ñ'eje nuni Huehuetlán ne ra ñ'kuta mra dänga Mictlán.
ri ñ'udi xajño nubia jankja beni ya metlaxcala bi do̱m'i mpaja nuya nso̱jo̱ kjä'i.	Ri ñudi xajño Nubia jankja beni ya Metlaxcala bi do̱m'i mpaha nuya nso̱ho̱ kjä'i.
t'ena ge inbi unga mfädi pa gatjo ya kjä'i mi ñ'oui, ge nuna ndada ra marqués da ñ'eje dra jmu ja ma jaije, da ja me̱ti nu'a di pe̱tsije neje dra kjakagije ga mpe̱fije ra jai ge bi umbabi o bi jänbabi ya joga jai ya n'añ'o jnini.	T’ena ge inbi hñäki mfädi pa gatjo ya kjä’i mi ñ’oi, ge nuna ndada ra marqués da ñ’eje dra jmu ja ma jaeje, da ja me̱ti nu’a di pe̱tsije neje dra kjakagije ga mpe̱fije ra jai ge bi umbabi o bi jänbabi ya joga jai ya n’añ’o jñeni.
xi mi taxki ra ñ'u, imbi tsa da r'anga n'a, jo̱nse̱je̱ mi taxka n'a ja ra bo̱jai. ya y'ofadi mi kju̱t'atjo.	Xi mi taxki ra ñ'ú, imbi tsa da r'anga n'a, jönsehe mi taxka n'a ja ra b'ojai. Ya y'ofadi mi k'üt'atjo.
ya dänga mfu̱nga bo̱kjä bi ntjo, bi kot'i ko ya majkjuai, mi zu̱m'i neje ko ya t'e̱nga ts'u̱t'abo̱kja.	Ya dänga mfu̱nga bo̱xjä bi ntjo, bi kot'i ko ya majkjuai, mi zu̱m'i neje ko ya t'e̱nga ts'u̱t'abo̱xjä.
ya r'atsanoya ra sajagún mi mä jankja mi yopa tsini. ya ndeznä bi nkoji inda ñ'udi. mi jatatjo pa bi mu̱di ra ntujni	Ya r'atsanoya ra Sajagún mi mä hank'a mi yopa ts'ini. Ya ndeznä bi nkoji nda ñ'udi. Mi jatatjo pa bi mu̱di ra nt'ut'uni.
ya zi b'e̱jña mi ägi ja ya b'a ne ja ya ngo̱de, nuya ñ'o̱jo̱ mbo ja ya ne, ja ya nkjom'ajudi.	Ya zi b’ejña mi ägi ja ya b’a ne ja ya ngode, nuya ñ’otho mbo ja ya ne, ja ya nkjom’ajudi.
bi boxro xi 'be̱ts'ina, bido'u̱ ro 'yu̱ni 'na, xi bi bo̱x ro hkjua 'na, bido'u̱ ro ts'ii 'na, xi bo̱xro ts'äre 'na. ge'bu̱ go min pu̱n doja 'na.	Bi boxro xi 'be̱ts'ina, bido'u̱ ro 'yu̱ni 'na, xi bi bo̱x ro hñä 'na, bido'u̱ ro ts'ii 'na, xi bo̱xro ts'äre 'na. Ge'bu̱ go min pu̱n doja 'na.
bi ma mankjuäntjo jabu̱ mi b'u̱i ra ts'e̱y'e̱jmu bi xipabi;	Bi ma mankjuäntjo ya hñäki mi b’ui ra ts’ei’e̱jmu bi xipabi.
bri kjuajni po nuya dra jmu.	Bri kjuäjni po nuya ra hmu.
di to̱m'ihe ra ñ'etji pa nugagije, n'a ra pa ngu ma n'a ra pa tjogi nekagije di juadije ra nge'a indi tse̱tije nuna b'u̱i t'o̱t'e ko ngekagije man'año ya ntjo, t'e̱nts'igije tji ma jaije ma me̱tije, ju̱kagije ga mpe̱fije nduntji, b'e̱kagije ga jut'ije xduntji ya bokja, n'a ngu n'a ra pa nuna nkjut'i di o̱t'eje man'a te ma tjaije di tuje.	Di to̱m'ihe ra ñ'et'i pa nugagije, n'a ra pa ngu ma n'a ra pa t'ogi nekagije di juadije ra nge'a indi tse̱t'ihe nuna b'u̱i t'o̱t'e ko ngekagije man'año ya ntjo, t'e̱nts'ihe tji ma jahe ma me̱t'ihe, ju̱kagije ga mpe̱f'ihe ndunt'i, b'e̱kagije ga jut'ihe xdunt'i ya bokja, n'a ngu n'a ra pa nuna nkjut'i di o̱t'ehe man'a te ma tjahe di tuhe.
gatjo nuna jai ja nuna r'ayo ximjai nkjabu̱ bi tjutuabi nuya nso̱jo̱jä'i inbi tsa bi tjutuabi man'a ra tjuju.	ga̱tho nuna̱ hai ya̱ nuna̱ ra̱yo xim'hai nkjabu̱ bi tjutuabi nuya̱ nzothojä'i inbi tsa bi tjutuabi man'a ra̱ tjuju.
ja mi tso nde, bi mu̱di bi nkja n'a ra jneki ngu nkjagiju̱ dega kjä'i, bi t'ot'e ra b'ai ngu dega kjä'i,	Xa mi tso nde, bi mudi bi nkya n’a ra ñeki ngu ñkagiju dega kä’i, bi t’ot’e ra b’ai ngu dega kä’i.
ma bo̱najmu'ije: nuna b'e̱fi ga tsokagije sta kjuatihe gatjo: gi nuti nuua, xa jño bo̱najmu.	Ma bo̱najmu'ije: nuna b'e̱fi ga tsokakije sta kjuathihe gatjo: gi nut'i nuha, xa ño bo̱najmu.
mi mä dega ts'e̱dira jñä tso̱pu da ts'o̱jo̱bu nuya nzo̱jo̱kjä'i ga jandiju̱ te ma ts'e̱di pe̱tsi, ra nge'a ma akjuä ra quetzalcohuatl b'u̱i nuua ko ngekagiju̱,	Mi mä dega ts'edi rañä ñä ts'opu da ts'ojobu nuya nzokojä'i ga jandiju̱ te ma ts'edi pe̱tsi, ra nge'a ma akjuä ra Quetzalcohuatl b'u̱i nuua ko ngekagiju̱.
ne ya nt'u̱i, jankja di tjuts'i ya nt'ofo, nkjap'u̱ neje mä 'ra ya mpeu̱i da fats'i di nt'ot'i ra jñäjñu	Ne ya nt’ui, hank’a di txuts’i ya nt’otho, nk’ap’ui neje ma ra ya mpeui da fätsi di nt’ot’i ra ñäñu.
nub'u̱ nu'i ingi kjapi da bo̱nga nu'a ra makja ja nu'a ra jnini, ¿jankja ra yotui, ga tso̱gi nubu̱ ma b'e̱jña? o̱t'a r'ato ya kje̱ya bi mu̱di [ra makja ra bartolomé lópez]	Nub'u̱ nu'i ingi kjapi da bo̱nga nu'a ra makxa ja nu'a ra jnini, ¿jankxa ra yotui, ga tso̱gi nubu̱ ma b'e̱jña? O̱t'a r'ato ya kje̱ya bi mu̱di [ra makxa ra Bartolomé López].
pa ga b'u̱i mpaja ne ga o̱t'e n'a ra nkjondajmä gatjo nu'a ga jandi.	Pa ga b'ui mpaha ne ga othe n'a ra nkjondajmä gatjo nu'a ga handi.
r'a nuna mi ntjandi ngu nu'a ma tjänkjuaju̱ (ychtlilmatli), xi mra nts'o, mi kuet'e ja ya ngo̱,	r'a nuna mi ntjandi ngu nu'a ma ñäñkjuäju̱ (ychtlilmatli), xi mra nts'o, mi kuet'e ja ya ngo̱,
xa zägi mpaja, nub'u̱ xa nkjabu̱ xa kjapabi ma zu ne inte xa t'o̱tuabi nub'u̱ inda kjapi xa po̱jo̱ bi ya kue̱ ra nge'a ya kjä'i xi mra no̱t'e ne mra jyotekjä'i,	Ja zägi mpaha, nu'bú ja njabu ja khäphabi ma zuh ne inte ja t'ot'obi nu'bú inda khäpi ja po̱ho̱ bi ya kue ra nge'a ya khä'i xi mra no̱t'e ne mra yotekhä'i.
y'o, ri ma ne gi xipabiju̱ ya metlaxcala ge ma r'a ya me̱ti kjä'i ne ri ajuäju̱, ge nu'a ga mä ge xa eje nuua ma jaiju̱, ge di umbabije ma ntjädije.	Ñu, ri ma ne gi xipabiju̱ ya metlaxcala ge ma ra ya me̱ti kjä'i ne ri ajuäju̱, ge nu'a ga mä ge xa eje nuua ma jaiju̱, ge di umbabije ma ntjädije.
¿te da o̱t'e ma kjä'iju̱ sta b'e̱diju̱?	¿Te da o̱t'e ma kä'i̱ju̱ nda b'e̱di̱ju̱?
-da ts'iua:... ri ñ'eje ge'a ma nkjueij'u̱. da o̱t'eje ya ñ'o̱te ko ya je̱m'i, ya ñ'o̱t'eje ko ya ntuts'i. da o̱ts'e̱ ra b'e̱na noya.	Da ts'iwa:... ri ñäjä gä ma nkjueij'u̱. Da o̱t'eje ya ñ'o̱te ko ya jämi, ya ñ'o̱t'eje ko ya nt'uts'i. Da o̱ts'e̱ ra bäna nuya.
-dom'i ma akjuäju̱ ge inda yu̱t'a ja ma nguju̱ nuju̱ to'o e̱nts'i pa tji ne da jokuabi ra jonanjyo nub'u̱ sta ne da jyoki ya inda za.	Dom'i ma akjuäju̱ ge hñä yu̱t'a ja ma nguju̱ nuju̱ to'o e̱nts'i pa tji ne da jokuabi ra jonanjyo nu'b'u̱ sta ne da jyoki ya hñä za.
-o̱t'a ra mäte gi o̱deju̱, kja gi b'ai nuuaju̱. mont'a ya ngo akjuä; ri kjuat'i ra ngo ga tsunda ma akjuäje.	-’ot’a ra mäte gi othehu, kja gi b’äi nuähu. m’ot’a ya ngo akjuä; ri kjuat’i ra ngo ga ts’unda ma akjuäje.
-xa jño, di b'u̱ije nkjamädije.	Xa ño, di b’uiye nkjamädiye.
-¿nguande nkjabu̱ ga mäu gra kjuäju̱?	-¿Nguandë ñ'k'abu̱ ga mäñu gra k'juäju̱?
-ñ'emabagi, ya gabida, ya kjä'iju̱ gi pädi ra ntuni ra mem'onda ba ejeju̱ ga te̱niju̱ma nzu̱teju̱. ko ya mätsa mi te̱je̱, ko ya bu̱'bai ko ngatjo ra ts'e̱di mi te̱je̱ ra ñ'u.	Ñ'emabaxi, ya gabida, ya kjä'iju̱ gi pädi ra ntuni ra mem'onda ba ejehu̱ ga te̱niju̱ma nzutehu̱. Ko ya mätsa mi teje, ko ya bu̱'bai ko ngatjo ra ts'e̱di mi teje ra ñ'u.
bi tse̱ti nuna ngot'i ra m'onda, ngu pede ra dänga b'ede, ya k'oi ne ya nkjändajmä, ngu nu'a ra jmä ra alonso axayaca, gojo n'ate ma pa bi nzo̱t'e nuna pa.	Bi tse̱ti nuna ngot'i ra m'onda, ngu pe̱de ra dänga b'ede, ya k'oi ne ya nkjändajmä, ngu nu'a ra jmä ra Alonso Axayaca, go̱ho n'ate ma pa bi nzo̱t'e nuna pa.
into y'o mankjuäntjo, into pa ri nektjo.	´ñotho y'o mankjuäntjo, ´ñotho pa ri nektjo.
nub'u̱ ndi umbabije ma nkjut'ije xki nzäi ndi da'ije, mi adi n'a tu̱ki neje nub'u̱ ndi unije ya k'astaboja mi jäni made n'a tu̱ki [...]	Nub'u̱ ndi umbabixe ma nkjut'ixe xki nzäi ndi da'ixe, mi adi n'a tu̱ki neje nub'u̱ ndi unixe ya k'astaboja mi jäni made n'a tu̱ki [...]
ya miñ'o ko ngejna jmä ri kjojya,	Ya miñ'o ko ngejna jmä ri kjojya.
bi tso̱jso̱ ra ngo ma akjuäju̱: nubia da fu̱di da guadi ra r'e̱t'a ra pa.	Bi tso̱iso̱ ra ngo ma akjuäju̱: Nubia da fu̱di da guadi ra r'e̱t'a ra pa.
