Input	Result
"-pasadores: ""ya nts'äza xi mra nts'u̱t'i mi t'e̱ni ko n'a ra t'e̱nga ts'u̱t'a bo̱ja mi thutuabi ra ballesta""."	"""ya nts'äza xi mra nts'u̱t'i mi t'e̱ni ko n'a ra t'e̱nga ts'u̱t'a bo̱ja mi thutuabi ra ballesta."""
cantares mexicanos, biblioteca nacional de méxico, ya nt'ofo 1628 bis, folio 16 v.	Cantares mexicanos, Biblioteca Nacional de México, ya nt’otho 1628 bis, folio 16 v.
"ebu̱ bi bo̱ni, bi meui nuni nonohualco, ha ra ngu ra b'ongui habu̱ ra gabida ne ra malintzin ne ""ra hyadi"" (alvarado) ne ra sandoval."	"Ebu̱ bi bo̱ni, bi meui nuni nonohualco, ha ra ngu ra b'ongui habu̱ ra gabida ne ra malintzin ne ""ra hyadi"" (Alvarado) ne ra Sandoval."
gi handi ra nt'ofo ra thuhu ra crónicas de la conquista	gi handi ra nt’ofu ra hñuhu ra crónicas de la conquista
guzmán. ha ya he̱m'i b'e̱tsa je̱ya manteb'u̱ di ge nuua m'onda ne ya hyo, nu'a ra hmä ra 12-conejo (1530) ge xa hmä ge xibú bi yut'i ha ra culhuacan ya ndeznä, nda pablo xochiquetzin, motelchiuhtzin ne ra guzman.	Guzmán. Ha ya hem'i b'etsa jeya mantebu di ge nuwa monda ne ya hyo, nu'a ra hmä ra 12-Conejo (1530) ge xa hmä ge xibú bi yut'i ha ra Culhuacan ya ndezna, nda Pablo Xochiquetzin, Motelchiuhtzin ne ra Guzmán.
ha ga ñ'udihu̱ ra nt'ofo ya ñämfo̱ po ra nthuts'i ra doctor garibay,	Ha gá ñ'udi̱hü ra nt'otho ya ñämfo̱ po̱ ra nthuts'i ra doctor Garibay.
ha nu'a hyodi nubia thutuabi ra san martin.	Ha nu’ä hñudi nu'bya thuthua bi ra San Martín.
he̱mi unga mfädi ha ra t'u̱ka hnini habu̱ b'u̱i ya jä'i teni ra división ra arenas, 27 ra abril ra je̱ya 1918, ra m'ets'a he̱m'i ra zapata, b'e̱tsi ha ra universidad nacional autónoma de méxico, expediente 29.	Hemi hunga mfädi ha ra t'uka hnini habu b'ui ya jä'i teni ra división ra arenas, 27 ra abril ra jëya 1918, ra m'ets'a hem'i ra zapata, b'ëtsi ha ra universidad nacional autónoma de méxico, expediente 29.
"m'e̱fa ha ra hñuti bri thätuabi na ra hñe xki tagiri mo̱te, nehe bri jom'a ra xu̱tha ko n'a ra t'axa dutu mra thuhuu ra ""campanillante""."	M’efa ha ra hñuthi bri thätuabi na ra hñe xki tagiri mote, nehe bri jom’a ra xutha ko n’a ra t’axa dutu mra thuhuu ra “campanillante”.
ma dada'ihe gra ts'u̱tui, di ne gi pädi ge ma me̱t'o instä thogihe nuna thogi gatho ya mapa xki r'ani, bi juat'i ko ngeke nu̱'u ri b'e̱go, ri me̱fi ya ñämfo̱, ra nge'a majuäni ra hernando cortés ra ndä gabida,	Ma tada'ihe gra ts'uthui, di ne gi pädi ge ma met'o instä thogihe nuna thogi gatho ya mapa xki r'ani, bi juat'i ko ngeke nu'u ri b'ëgo, ri mefi ya ñämfo, ra nge'a majuäni ra Hernando Cortés ra ndä gabida.
mi b'u̱i ya mu̱dimehai mi ñä ra ndeznä ne habu̱ ra hnini dige'a gatho ra nxiki m'onda ngu r'a ya yaqui b'u̱i nuni sonora ne ya maya ri ñ'ehe nuni yucatán ra nge bi guat'i ha ra tuhni bi nja nuua m'onda fädi ko ra thuhu ra revolución mexicana ya je̱ya 1910-1919.	Mi b'ui ya mu̱dimehai mi ñä ra ndeznä ne habu̱ ra hnini dige'a gatho ra nxiki m'onda ngu r'a ya yaqui b'ui nuni Sonora ne ya maya ri ñ'ehe nuni Yucatán ra nge bi guat'i ha ra tuhni bi nja nuua m'onda fädi ko ra thuhu ra Revolución Mexicana ya je̱ya 1910-1919.
mi fo̱tuabi ya ts'u̱tnibo̱ja mi thutuabi ya hñämfo̱ ra pasadores nehe ya bo̱zna ko ya nzafi.	Mí fotuabi ya ts'utnibo̱jä mi thutuabi ya hñämfo̱ ra pasadores nehe ya bo̱zna ko ya nzafi.
n'a nt'udi di ge'a nuya nthoki bri t'o̱t'e ha ya hñä ya ndeznä ra ngätsi ra nthebe nje̱ya ra r'e̱t'a ma gu̱to (s. xix), r'a ya hnini ngu ra xicontepec (villa juárez) nuna hyodi kohi nuni puebla.	N’a nt’udi di ge’a nuya nthoki bri t’ot’e ha ya hñä ya ndeznä ra ngätsi ra nthebe jëya ra r’ët’a ma guto (s. xix), r’a ya hnini ngu ra Xicontepec (Villa Juárez) nuna hyodi kohi nuni Puebla.
"n'a ra t'axa dutu mi pe̱tsi ya k'oi ra ixki, nuna mra thuhu hñämfo̱ ""campaneante resonador""."	N’a ra t’axa dutu mi pe̱tsi ya k’oi ra ixki, nuna mra thuhu hñämfo̱ “campaneante resonador”.
ne ri mpe̱fi ha ra dängan gu nt'udi ra thuhu ra facultad de estudios superiores, acatlán, unam,	Ne rï mpe̱fi ha ra dängandä gu nt’udi ra thuhu ra Facultad de Estudios Superiores, Acatlán, UNAM.
nthandi gatho nu'a ra munts'i ra thuhu hñämfo̱ ra globalización ge 'a po̱ts'e dega nest'ihi, nuna y'o̱te to̱m'i da nja ra ntho̱mäte.	Nt'andi gatho nu'a ra mints'i ra thu̱hu̱ hñä mfo̱ ra globalización ge 'a po̱ts'e dega nest'i, nuna y'o̱te to̱mi da nja ra ntho̱mäte.
nu'a ma r'a ya jä'i mi pädi nuña b'e̱fi bri b'e̱pabi xa hyoki yoho ya mpe̱fi mi fädi ko ra thuhu ra amosqueador ko ya xi ya ts'ints'u̱ xi sta hotho, gi hutsuabi made dige'a n'a ra zänä dega k'astaboja	nu'a ma r'a ya jä'i mi pädi nuña b'e̱fi bri b'e̱pabi xa hioki yoho ya mpe̱fi mi fädi ko ra thuhu ra amosqueador ko ya xi ya ts'ints'u̱ xi sta hotho, gi hutsuabi made dige'a n'a ra zänä dega k'astaboja
"nu'a ra munts'a jä'i bi te̱ni bi zipabi man'a ya b'ede, mi t'ena ge ya jä'i xki b'u̱i nubu̱ inbi pe̱tsi ra ts'e̱di nu'a mi mä pe m'e̱fa bi japi bi nxaxni ya tsu̱tui ne n'a ra diputado mi pe̱tsi ra mfeni xki kot'i mra thuhu ra josé maría lozano, bi y'onga ra hmä pa mar'a ya ñ'oui bi nxanxi: ""ri mo̱te ra thits'i mi udi ra emiliano zapata, nehe bri fädi ngu ra atila nuna bri nju̱tsi [...] nu'a bi fädi ngu mi he̱gi ya b'e̱go ne'a bi mä da uni da nja pa gatho, ingi jot'i [...]"	"nu'a ra mints'a jä'i bi te̱ni bi zipabi man'a ya b'ede, mi t'ena ge ya jä'i xki b'u̱i nubu̱ inbi pe̱tsi ra ts'e̱di nu'a mi mä pe m'e̱fa bi japi bi nxaxni ya tsu̱tui ne n'a ra diputado mi pe̱tsi ra mfeni xki kot'i mra thuhu ra josé maría lozano, bi y'onga ra hmä pa mar'a ya ñ'oui bi nxanxi: ""ri mo̱te ra thits'i mi udi ra emiliano zapata, nehe bri fädi ngu ra atila nuna bri nju̱tsi [...] nu'a bi fädi ngu mi he̱gi ya b'e̱go ne'a bi mä da uni da nja pa gatho, ingi jot'i [...]"
nu'u̱ to'o ñä ra ndenzä ha r'e̱t'a ma r'at'o ya estados.	Nthu̱ to'o ñä ra nthe̱nthä ha r'e̱t'a ma r'at'o ya estados.
nub'u̱ ri m'e̱hni ne ri b'e̱go ya ñämfo̱ bi juat'i ko ngekagihe ne bi tso̱ho̱ ra gabida ra thuhu ra hernán cortés, maske indi pädihe ge gatho da za da o̱t'e ne xi ra nzunda maría trinidad,	Nub'ú ri m'ehni ne ri b'ehgo ya ñämfo̱ bi juat'i ko ngekagihe ne bi tso̱ho̱ ra gabida ra thuhu ra Hernán Cortés, maske indi pädihe ge gatho da za da o̱t'e ne xi ra nzunda María Trinidad.
nubia, unga mfädi ha ra ñähñu jamädi ra universidad autónoma del estado de hidalgo.	Nubia, 'na mfädi ha ra ñäñho jamädi ra Universidad Autónoma del Estado de Hidalgo.
nugi, ra miguel hernández ge di pe̱tsi ma ngu nuni chiyauhtzinco, ko ra t'ek'ei di udi ko nge'i, nuna m'e̱hnant'ofo di hoki go tso̱n'i ko nge'i, ma t'ek'ei bo̱nahmu'i nda doctor alonso ruiz, ra nk'ohnate ge gi b'ui nuua ha ra hnini ra quamochtitla.	Nugi, ra Miguel Hernández ge di pe̱tsi ma ngu nuni Chiyauhtzinco, ko ra t'ek'ei di udi ko nge'i, nuna m'e̱hnant'ofo di hoki go tso̱n'i ko nge'i, ma t'ek'ei bo̱nahmu'i nda Doctor Alonso Ruiz, ra nk'ohnate ge gi b'ui nuua ha ra hnini ra Quamochtitla.
nuna he̱m'i bri t'unga mfädi ko ra t'u̱ka nthint'ant'ofo po ra marcelo díaz salas ne ra luis reyes garcía ha: tialtocan, revista de fuentes para el conocimiento de las culturas indígenas de méxico, vol. vi, 1970, b'ede ra 3, pp. 193-212.	Nuna hëmi bri t'unga mfädi ko ra t'uka nthint'ant'otho po ra Marcelo Díaz Salas ne ra Luis Reyes García ha: Tialtocan, Revista de Fuentes para el Conocimiento de las Culturas Indígenas de México, vol. VI, 1970, b'ede ra 3, pp. 193-212.
"nuna hñäpi huts'i ha n'a ra he̱m'i fädi ra derecho canonigo ko ra thuhu hñämfo̱ ngu ra ""solicitación al administrar el sacramento de la confesión""."	"Nuna hñäpi hutsi ha n’a ra hëm’i fädi ra derecho canónico ko ra thuhu hñämfo ngu ra ""solicitación al administrar el sacramento de la confesión""."
nuna m'e̱hna nt'ofo b'e̱tsi ha ra archivo histórico nacional, madrid, documento 165. bi unga mfädi ha ra nt'ofo ya zubi po ra y'ofo ra thuhu ra arthur j. o. anderson et al.: byond the codices: the nahua view of colonial mexico, berkeley, university of california press, 1976, pp. 181-187.	Nuna m’ehna nt’otho b’ets’i ha ra archivo histórico nacional, Madrid, documento 165. Bi unga mfädi ha ra nt’otho ya zubi po ra y’otho ra thuhu ra Arthur J. O. Anderson et al.: Beyond the Codices: The Nahua View of Colonial Mexico, Berkeley, University of California Press, 1976, pp. 181-187.
nuna nt'ofo b'e̱tsi ha ra archivo general de indias, sevilla, audiencia de méxico 168, bi unga dra fädi po ra miguel león-portilla ha cultura en peligro, méxico, alianza editorial mexicana, 1976, pp. 102-103.	Nuna nt’otho b’ëtsi ha ra Archivo General de Indias, Sevilla, Audiencia de México 168, bi unga ra fädi po ra Miguel León-Portilla ha Cultura en Peligro, México, Alianza Editorial Mexicana, 1976, pp. 102-103.
nuna pika he̱m'i ja te mä b'e̱tsi ha ra archivo general de la nación, nuua m'onda ne ja ha ra ndunthi ya hnini, njabu̱ ngu ya nzaya nuni manhyati ne mar'a ya hnini, o̱t'e gi o̱de ra hñä ra mu̱dimehai.	Nuna pika he̱m'i ja te ma b'e̱tsi ha ra Archivo General de la Nación, nuwa m'onda ne ja ha ra ndunthi ya hnini, njabu̱ ngu ya nzaya nuni manhyati ne mar'a ya hnini, o̱t'e gi o̱de ra hñä ra mu̱dimehai.
nuua t'unga yoho ya hmä, kuän'ahmä ya ndeznä ne thuts'i ha n'a ra k'oi mä mäjuäni ri nthe̱ui n'a ya dänga ra thu̱ahmä manteb'u̱, nuua pede nu'a gatho ya ts'othogi bi y'o̱t'a dega fete ra alvarado.	Nwä t'unga yoho ya hmä, kuän'ahmä ya ndeznä ne thuts'i ha n'a ra k'oi mä mäjuäni ri nthe̱ui n'a ya dänga ra thu̱ahmä manteb'u̱, nwä pede nu'a gatho ya ts'othogi bi y'o̱t'a dega fete ra Alvarado.
nuua ya mu̱di noya ra motolinia, ha ra mu̱di nkohi bi t'o̱t'e ko ra thuhu ra tratado tercero ra dänga b´ede ya mu̱dimehai nuua r´ayo manhyati:	Nwua ya mudi nuya ra Motolinia, ha ra mudi nkohi bi t'ot'e ko ra thuhu ra tratado tercero ra dänga b'ede ya mudimehai nwua r'ayo manhyati:
"pa da t'unga mfädi gatho nu'u̱ bi nja, n'a di ge'u̱ ko ngu fe̱ti nu'a majuäni mi hoki mi thutsuabi ya hnei ne ya b'ida. b'u̱i man'a ra mfädi da t'o̱t'a ra nt'udi, nu'a ra thuhu ""fe̱ta nu'a majuäni bi nja nub'u̱ ra tsokat'o̱tamfeni (teatro de la conquista)""."	"Pa da t'unga mfädi gatho nu'u̱ bi nja, n'a di ge'u̱ ko ngu fethi nu'a majuäni mi hoki mi thutsuabi ya hnei ne ya b'ida. B'u̱i man'a ra mfädi da t'o̱t'a ra nt'udi, nu'a ra thuhu ""fetha nu'a majuäni bi nja nub'u̱ ra tsokat'o̱tamfeni (teatro de la conquista)""."
ra europa -mra nxika hai manteb'u̱, mi pe̱tsa n'a ra nxika b'ede-	Ra Europa mra nxkiha hai manteb'u̱, mi pe̱tsa n'a ra nxkiha b'ede.
ra fernando ramírez mä ge nuna hyodi ri nge̱pu̱ habu̱ ja n'a ra nija ra san fernando ne ra ermita dige'a ya mártires dige'a san hipólito,	Ra Fernando Ramírez mä ge nuna hyodi ri nge̱pu̱ habu̱ ja n'a ra nija ra San Fernando ne ra ermita dige'a ya mártires dige'a San Hipólito.
"ra fernando de alva ixtlilxóchitl, fernando de, xiii relación: ""ra ñ'ehe ya ñämfo̱ ne ra fu̱di ra nkanfri ra evangelio""."	"Ra Fernando de Alva Ixtlilxóchitl, Fernando de, XIII Relación: ""Ra ñ'ehe ya ñämfo̱ ne ra fu̱di ra nkanfri ra evangelio""."
ra kuän'ahma ra n luz jiménez bi huts'i ra fernando horkasitas bi unga mfädi ne bi r'atsi nuña hmä), de porfirio díaz zapata, memoria nábuatl de milpa alta, méxico, unam,, instituto de investigaciones históricas, 1974, p. 105	Ra kuän’ahma ra N. Luz Jiménez bi Huts’i ra Fernando Horkasitas bi unga mfädi ne bi r’atsi nuña hmä), de Porfirio Díaz Zapata, Memoria Náhuatl de Milpa Alta, México, UNAM, Instituto de Investigaciones Históricas, 1974, p. 105.
ra raymundo isidro alavez, bi b'u̱i'i nuni ra boxtha chico, san salvador, estado de hidalgo	Ra Raymundo Isidro Alavez, bi b’ui’i nuni ra boxtha Chico, San Salvador, Estado de Hidalgo.
ra hmä ra fundación de santo tomás ajusco, archivo general de la nación, méxico, ramo de tierras vol. 2676, expediente. 4, archivo histórico de la biblioteca nacional de antropología, colección antigua, vol. 254, fojas 259 r.- 260 v.	Ra hmä ra Fundación de Santo Tomás Ajusco, Archivo General de la Nación, México, Ramo de Tierras vol. 2676, expediente. 4, Archivo Histórico de la Biblioteca Nacional de Antropología, Colección Antigua, vol. 254, fojas 259 r.- 260 v.
ra makja mra thuhu ra toribio benavente, motolinia,	ra makxa mra thuhu ra Toribio Benavente, Motolinia,
tlauhquechol: ra ts'ints'u̱ xa ntheni pode ge'a ra flamenco o ra guacamaya, pode ge gatho ra the̱nga ts'ints'u̱ ne dänga.	Tlauhquechol: ra ts'ints'u̱ ja ntheni pode ge'a ra flamenco o ra guacamaya, pode ge gatho ra the̱nga ts'ints'u̱ ne dänga.
xkri tso̱ngä ngosthi, ja hehni ya 'ñu; nä'ä rí ma nxamädo, ha nä'ä rí ma mäbo̱za. antes de	xkri tso̱ngä ngosthi, ja heni ya ñu; nä'ä ri ma nxamädo, ha nä'ä ri ma mäbo̱za. antes de
ya b'e̱go ne ya b'e̱tri di ge'a nu'a ra dänga ndä ra ndada ra thuhu ra esteban de guzmán ra nzaya di gekua m'onda, ra ndada ra hernando pimentel, ra ndada ra antonio cortés, ra ndada xuua (juan) nuna ra mecoyoacan, ra ndada pedro motecuhzoma, me ma r'a ya kuänmi (firmas).	Ya b’ëgo ne ya b’ëtri di ge’a nu’a ra dänga ndä ra ndada ra thuhu ra Esteban de Guzmán ra nzaya di gekua m’onda, ra ndada ra Hernando Pimentel, ra ndada ra Antonio Cortés, ra ndada Xuua (Juan) nuna ra Mecoyoacan, ra ndada Pedro Motecuhzoma, me ma r’a ya kuänmi (firmas).
ya kuän' ahmä xa thogi manteb'u̱e ge xa thäst'i nu'a gatho ra nthandi to'o bi b'e̱di ge xa pu̱ngahñä nuna hmä getbu̱ n'ate ya hñäki ge ñä ya nso̱ho̱ hñäki ne xa y'oni nuna nt'ofo nehe ha ra hñäki yazi xada jä'i , ge'a nuna hñäki fadi ha ra hñämfo ko ra thuhu ra sistema braile.	Ya kuän' ahmä xa thogi manteb'u̱e ge xa thäst'i nu'a gatho ra nthandi to'o bi b'e̱di ge xa pu̱ngahñä nuna hmä getbu̱ n'ate ya hñäki ge ñä ya nso̱ho̱ hñäki ne xa y'oni nuna nt'ofo nehe ha ra hñäki yazi xada jä'i, ge'a nuna hñäki fadi ha ra hñämfo ko ra thuhu ra sistema Braille.
ya r'atsanoya ra sahagán, ndoxjua k'oi florentino, lib. xii, caps. xxix-xli (versión de ángel ma. garibay k.).	Ya r'atsanoya ra Sahagán, ndoxjua k'oi Florentino, lib. XII, caps. XXIX-XLI (versión de Ángel Ma. Garibay K.).
despwés ya desde k'a ra momento ya k'a ya híngi bénya'wi já té bimáhhu̱ k'a ra txarroya'wi	Despuéshä ya desde k’ä ra momento ya k’ä ya hingi béñawi ja te bima’hu̱ k’ä ra txarroyañwi.
despwés ya xo bimu̱fí pe xo diario diario bu̱ ntxúi mitsu̱ k'a ra txarro mi'óbí k'a ra mikwála	Despué́s ya xo bimu̱fí pe xo diario diario bu̱ ntxúi mitsu̱ k'a ra txarro mi'óbí k'a ra mikwála
gopareháhé primero 'á k'a ra parte ánk'ú dínant'í	Gopareháhe primero 'a k'a ra parte 'ank'u dinant'i.
i asta fecha pues ignoro mucho pero másk'ŭ mäjámá más ndímáignorahéwi	I hñä fecha pues ignoro mucho pero másk'ŭ mäjäm'ä más ndí mä ignorahewi.
indu̱odiagí bastante	ñu̱thogi bastante
inga se̱he̱ ra nnthandi ra manhyati ne ra portuguesa nehe ra francesa, inglesa, alemana e italiana,	Inga se̱he̱ ra nthandi ra manhyathi ne ra portuguesa nehe ra francesa, inglesa, alemana e italiana.
k'a mädämé para ke mantenigíhé dígothó mäbähtsí pues ni modo dísufréhé	k’a mädäme para ke mantenigihe dígothó mäbätsi pues ni modo disufrehe
kómá'u̱té ya fuente níhí	kómá'ute ya fuente ñuhi
ne bi unbabi ndunthi ya baba, bi enbabi ge mi ne da ñäui ra ndä (emperador) mi b'u̱i nuni manhyati, ne da häni ra dänga ts'ofo ra evangelio,	Nde bi unbabi ndunthi ya baba, bi enbabi ge mi nde da ñäwi ra ndä (emperador) mi b'ui nuni manhyathi, nde da häni ra dänga ts'ofo ra evangelio,
normalmente góho	Normalmenthe góho
panteón ga dó	pantheon ga do
pero de sesenta pantsíthá pa gothók'ŭ kompletamente xathó ndímáfădihé	Pero de sesenta pantzítha pa gothoki completamente xatho ndímafadhihe.
pero eso sí binúhgí mängŭhé kada ná	Pero 'ñätho bíhñu mängu̱hë kada nä.
"po nuya ja'i to'o mi pede ge fädi ko ra thuhu ya ""cronistas de las indias"""	"po nuya ja’i to’o mi pe̱de̱ ge̱ fädi ko ra thuhu ya ""cronistas de las indias"""
pues este kábádá balewa este mínimo siento sinkwenta	Pues este kábada balewa este mínimo siento sinkuenta
pues nimodo bisufré k'a más ante mäabwelitahé komo mbu̱i enkahoso ra ntsoya	Pues ni modo bi sufre k'a más ante ma mbelithahe komo mbui enka hoso ra nts'oya
ra nku̱t'i ra huahni ne ya ñ'udi nthutsi ra agustin yáñez 2da. edición. biblioteca del estudiante universitario, unam, 1950.	Ra ncut'i ra huäni ne ya ñudi nthutsi ra Agustin Yáñez 2da. edición. Biblioteca del Estudiante Universitario, UNAM, 1950.
solamente ya riko alkansabi	Solamente ya riko alkansabi
xi ra tí na ta komedór 'á itsí na ta alimento k'a ra ndăni	Xi ra ti na tha komedor 'a its'i na tha alimento k'a ra ndäni.
xo mitahá ra ntsoya mitá sínko pesos ra béhña dos sinkwenta	Jwä mit'aha ra nts'o̱ya mit'a hño̱tho pesos ra béhña dos sinkwenta
xo taja mä sesenta wik'a taja mä sesenta bitahkíhéya'wik'a	Jo̱ t'aja ma̱h se̱hnta wi̱k'a t'aja ma̱h se̱hnta bita̱hk'ihe̱ya'wik'a
á panteón ga dó níhí	ʔa panteón ga do̱ nihi̱
ñúdigehña dabadihíya' razo''ya' mientra más dandu̱hté	ñudi̱gehnä dämadi̱hí mä räzo̱ mä miéntra más dändu̱hte̱
-nu'u̱ dige'u̱ b'u̱i nuni maxey (tolimán ne amealco), dige'u̱ temoaya nuni ra ra hyodi estado de méxico ne mar'a ya hyodi nuni puebla ne veracruz	Ñuhu digehu b'ui nuni maxei (Tolimán ne Amealco), digehu Temoaya nuni ra ra hiode Estado de México ne mar'a ya hiode nuni Puebla ne Veracruz.
ne mätahekitho di ja getbu̱, ra hñäpi ra joel martinez hernández ne ra hotho thuahmä ra natalio hernández xocoyotzin, nuya yoho ya xahnate ri ñ'ehe ya y'u̱ dige'u̱ ya ndeznä.	Ne mätaheki hño di ja getbu̱, ra hñäpi ra Joel Martínez Hernández ne ra hotho thuahmä ra Natalio Hernández Xocoyotzin, nuya yoho ya xahnate ri ñ'ehe ya y'u̱ dige'u̱ ya ndeznä.
"-n'ate pa n'a ra zänä de ra r'e̱t'a ma hñäto ""zänä"" mi zo̱ta ya munts'i ya n'ate ya pa ge mi hoki ra xihuitl o ""ra m'ede ra je̱ya"""	"Nate pa na ra zänä de ra r'eta ma hñäto ""zänä"" mi zota ya munci ya nate ya pa ge mi hoki ra xihuitl o ""ra m'ede ra jeya"""
bi ma di gepu̱ ham''u̱ ra ngo pa da ts'ithe ya it'adehe (Tlahuano) ba po̱ni nubu̱ tlapechhuan. mra ngo ra Izcalli.	Bi ma di hñepu̱ hamu̱ ra ngo pa da ts'ithe ya it'adehe (Tlahuano) ba po̱ni nubu̱ tlapechhuan. Mra ngo ra Izcalli.
bi mu̱di da hyoka ya t'u̱kats'u̱fabo̱ja. ge'a ra ntuhni bi nja nuni Coyohuehuetzin ne ma goho ba nja.	Bi mudi da ñoka ya thuhkatthufaboja. Ge'a ra ntuhni bi nja nuni Coyohuehuetzin ne ma goho ba nja.
bri tho ra cuauhnochtli, ra gabida tlacatecco, ra cuapan, ra gabida huitznáhuac, ra makja Amantlan, ne ra makja tlacopan.	B’ri to ra kuau̱noxtli, ra ngabi̱da tlakathek’o, ra kuapan, ra ngabi̱da wit͜sna̱wak, ra makxa̱ Amantlan, ne ra makxa̱ tlakopan.
bri ts'u̱tuabi ha ra y'u̱ga n'a ra nto̱de dega t'u̱ka hoga do dega chalchihuite: made mi huts'i n'a ra tsant'i dega k'astaboja.	B'ri ts'utuabi ha ra y'uga n'a ra nt'ode dega t'uka hoga do dega chalchihuite: made mi hutsi n'a ra tsant'i dega k'astaboja.
Castañeda, ra t'u ra Aquiyahualcatecuhtli, m ra ndä nuni tlaxcala.	Castañeda, ra tu̱ ra Akuiyahualkatekuhtli, m ra ndä nuni Tlaxcala.
Coaíhuitl mra gabida ndeznä nuya mapa digeá ra t'o̱t'ats' okamfeni.	Kuaíhuitl mra habida ndetsnä nuya mapa digea ra t'ot'ats' okamfeni.
di gepu̱ ba koi pa nuni ra Xochimilco. nubu̱ ba tu ya jä'i ya metlatelolco	Di hñepu̱ ba k'oi pa nuni ra Xochimilco. Nubu̱ ba tu ya jä'i ya Metlatilolco.
ebu̱ ba ehe man'aki ba te̱nga ra t'o̱ho̱ ra thuhu ra Citlaltépec. Tlacopan, nubia ba o̱t'ra b'u̱i ha ra ndo̱m'ihmu.	Ebo̱ ga ehe man'aki ga te̱nga ra t'o̱ho̱ ra thuhu ra Citlaltépec. Tlacopan, nuvia ga o̱t'ra b'o̱i ha ra ndo̱m'ihmu.
ebu̱ bi dädi ra Cihuacóatl:	Ebo̱ bi dädi ra Cihuacóatl:
ebu̱ bi ñä ra Cuauhtémoc bi xipabi ra Cihuacóatl:	Ebo̱ bi ñä ra Kuauhtémoc bi xipabi ra Sihuakóatl:
goho n'ate ya pa ne ebu̱ bi yopa bo̱ni pa di mani ra Huaxtepec, ra Cuauhnahuac (Cuernavaca).	Goho n’ate ya pa ne ebu̱ bi yopa bo̱ni pa di mani ra Huaxtepec, ra Kuauhnahuac (Cuernavaca).
gue dá nhuat'i mbo ja ra ximhai,	Güi dá ñwät'i mbo ya ra Ximhäi,
i nte ra nge'a, ya hmä huts'i ha ra ndäxjua k'oi ra códice ra ramírez uni nuna b'e̱de mä majuäni ngu mä ra nthe̱ka b'ede ne ra ndädi nu'a ra nänä mra thuhu ra yacotzin, ra nänä ra ixtlilxóchitl,	I nthé ra nge'a, ya hmä huts'i ha ra ndäxjua k'oi ra códice ra Ramírez uni nuna b'ede mä majuäni ngu mä ra nthéka b'ede ne ra ndädi nu'a ra nänä mra thuhu ra Yacotzin, ra nänä ra Ixtlilxóchitl.
inda hyo ko ra ndäxjua ixtlilxóchtil, ra dada ra Nezahualcóyotl ni ko ra fernando de alva ixtlilxóchitl.	ʔinda hyo ko ra ndäxjuä ixtlilxóchitl, ra dada ra Nezahualcóyotl ni ko ra Fernando de Alva Ixtlilxóchitl.
k o ya bu̱' bai, ko ya makahuai,	Gó ya bu̱' bä, gó ya makahuai,
mi fudi da t'axka ra xudi ba ts'i, bri thát'a ha n'a ra za mi b'ai ha ra ngu ra Ahuizotzin nuni ra Acatliyacapan.	Mi fudi da t’axka ra xudi ba ts’i, bri thát’a ha n’a ra za mi b’ai ha ra ngu ra Ahuizotzin nuni ra Acatliyacapan.
mi gu̱t'a ra ñ'u̱ n'a ra makja ge'a mra b'e̱fi mi zu nu'a ra mäka hai mra thuhu ra Yohualichan.	Mi gúta ra ñ'ú na ra makxa ge'a mra b'efi mi zu nu'a ra mäka hai mra thuhu ra Yohualichan.
mi y'o y'oua, mi tuts'i ya bu̱'bai dega za, ne r'a mi hä dega bo̱ja ne ya mahuai.	Mi y'o y'owa, mi t'utsi ya bu'bai dega za, ne ra mi hä dega boja ne ya mahuai.
mra ngu ra Aztautzin ge'a mi ja getbu̱ nuni ra Amáxac.	Mä ra ngu ra Aztautzin ge'a mi ja get’bu̱ nuni ra Amáxac.
n'a ra hyo ne man'a bi xokuabi ra debi. ra Cuauhtemoctzin bri xokuabi ra debi ge'a se̱he̱.	Nda ra hyo ne man'a bi xokuabi ra debi. Ra Cuauhtemoctzin bri xokuabi ra debi ge'a se̱he̱.
ne m'e̱fa bi ma xki häki ya he dega magabi, ñätsi bi ntsaya ra mahuai ne ra bu̱'bai, bri njonda ya bo̱nahmu nuni Acachinanco.	Ne m’efa bi ma xki häki ya he dega magabi, ñätsi bi ntsaya ra mahuai ne ra bu'bai, bri njonda ya bonahmu nuni Acachinanco.
ne njabu̱ bri t'ot'e nehe ko mar'a ya bo̱nahmu mi pe̱tsi ra t'u̱ka tsu̱tui ha ya t'u̱ka hnini, nuyu̱ to'o mi b'e̱pi da t'o̱t'e ngu nuni Xalapan, Tlaxcalan, Tehuantepec, Oaxaca nehe mar'a ya bo̱nahmu mar'a ya t'u̱ka hnini habu̱ bi guat'i ya nduste, ya dumanthuhu dega k'astaboja, ge ya thuhu ya kristiano [...]	Ne ñäñho̱ b'ri t'ot'e nehe ko mar'a ya bo̱na hmu mi pe̱tsi ra t'u̱ka tsu̱tui ha ya t'u̱ka ñäñho̱, ñu̱y'u̱ to'o mi b'e̱pi da t'o̱t'e ngu nuni Xalapan, Tlaxcalan, Tehuantepec, Oaxaca nehe mar'a ya bo̱na hmu mar'a ya t'u̱ka ñäñho̱ habu̱ bi guat'i ya nduste, ya dumanthuhu dega k'astaboja, ge ya thuhu ya kristiano [...]
ne nu'a ri däme, pu̱ ñ'a'i, nugi ga ma ga tsogi'i nuni Cuetlachcoapan [n'a ra hnini nuni puebla],	Ne nu'a ri däme, hñäki ñä'i, nugi ga ma ga tsogi'i nuni Cuetlachcoapan [ñä ra hnini nuni Puebla],
ne nu'u̱ bi mani dra ts'okat'o̱t'amfeni nuni Michoacán, Xalisco, Culhuacan ne nuni nehe Pánuco, ne nuni Oaxaca, Tehuantepec ne Guatemala, ne nuua ra r'ayo mahyati, nub'u̱ bri t'o̱t'a ra mabagi pa dra uadi dra t'o̱t'a nu'a ra ts'okat'o̱t'amfeni inda tsogihe se̱he̱.	Nde nu'u̱ bi mani ra ts'okat'o̱t'amfeni nuni Michoacán, Xalisco, Culhuacan ne nuni nehe Pánuco, ne nuni Oaxaca, Tehuantepec ne Guatemala, ne nu'u̱ ra r'ayo mahyati, nu'b'u̱ bri t'o̱t'a ra mabagi pa ra uadi ra t'o̱t'a nu'a ra ts'okat'o̱t'amfeni nda tsogihe se̱he̱.
nehege'a ra ngätsi. mi hä ya mpe̱fi dega mabagi,ya njom'a te ne ya fu̱nbo̱ja, inte ma mahuai mi hä ni ge'a ya bu'bai.	Nehege'a ra ngätsi. Mi hä ya mpefi dega mabagi, ya ñom'a te ne ya funboja, inte ma mahuai mi hä ni ge'a ya bu'bai.
njabu̱ bi bo̱nga dega xui. mra ngo nub'u̱ ra Tecuílhuitl bi bo̱nga: nub'u̱ bi ja ya du ha ra r'ani ra dehe ya u̱erna.	ñaju̱ bi bo̱nga dega xui. mra ngo nu'b'u̱ ra Tecuílhuitl bi bo̱nga: nu'b'u̱ bi ja ya du ha ra r'ani ra dehe ya u̱erna.
nub'u̱ bi thandi ra Tzihuacpopoca, bi t'ena:	Nub'u̱ bi thandi ra Tzihuacpopoca, bi t'ena:
nub'u̱ ya ñämfo̱ bi handi ge xa ñ'ehe nubu̱ da tsu̱di, ge mi tekuabi ra nest'ihi, m'estho bi munts'i bi mihi ya mahuai.	Nub'u̱ ya ñäñfo̱ bi handi ge xa ñ'ehe nubu̱ da tsu̱di, ge mi tekuabi ra nest'ihi, m'estho bi munts'i bi mihi ya mahuai.
nuna jä'i inbi tsa bi thädi majuäni nu'a ra nt'ani. ingra nge'a nuya pa bi hneki n'a ra hyoya jä'i ra macehual (hombre de pueblo),	Nuna jä’i inbi tsa bi thädi majuani nu’a ra nt’ani. Ingra nge’a nuya pa bi hneki n’a ra hyoya jä’i ra masehual (hombre de pueblo),
nuna nte̱nga b'ede ha bri hat'i ra Tzihuacpopocatzin, bi o̱t'e da thogi ge'a ra ts'e̱y'e̱hmu. inbi bo̱nga nuna nt'o̱t'e bi tsu̱dihu̱ ko ma r'a ya b'e̱hni. ma ra ya ñ'ete inbi hopi da ju̱ man'aki ra ñ'u nuya ts'okate. pe nuya inbi hoki ra b'ai.	Nuna nte̱nga b'ede ha bri hat'i ra Tzihuacpopocatzin, bi o̱t'e da thogi ge'a ra ts'e̱y'e̱hmu. Inbi bo̱nga nuna nt'o̱t'e bi tsu̱dihu̱ ko ma r'a ya b'e̱hni. Ma ra ya ñ'ete inbi hopi da ju̱ man'aki ra ñ'u nuya ts'okate. Pe nuya inbi hoki ra b'ai.
nuua di udihe ra hñäpi bi nto̱t'e bi nja ra agosto ra je̱ya 1595, n'a ra jä'i mra thuhu ra miguel hernández, ra me Chiyauhtzinco,	Nwä di udihe ra hñäpi bi nt’ot’e bi nja ra agosto ra jäya 1595, n’a ra jä’i mra thuhu ra Miguel Hernández, ra me Chiyauhtzinco,
nuya bo̱nahmu ya mem'onda ñätsi bi ñäui ra Cihuacóatl Tlacotzin m'estho bi thädi:	Nuya bo̱nahmu ya mem'onda ñätsi bi ñäwi ra Cihuacóatl Tlacotzin m'estho bi thädi:
ra Tlacatécatl mra me Cuauhtitlan ne ra bktri ra mbot'a ngu bri japi ya tsat'yo bi zi.	Ra tlakatékathl mra me Kuauhtitlan ne ra büktri ra mbotha ngu bri hapi ya tsathyo bi zi.
ra doy'e̱ pahni xki njom'i ko ya chalchihuite.	ra doye̱ pahni xki ñomi ko ya chalchihuite.
ra mu̱di ra Cuauhtémoc, ra hmu ra bondo, ra nyoho ra Tlacotzin, ra Cihuacóatl ra nhñu ra oquiztzin, ra bo̱nahmu ha ra nini ra Azcapotzalco Mexicapan, ra ngoho ra panitzin, ra bo̱nahmu nuni ra Ecatepec,	ra mudi ra Cuauhtémoc, ra hmu ra bondo, ra ñoho ra Tlacotzin, ra Cihuacóatl ra ñuhu ra oquiztzin, ra bonahmu ha ra nini ra Azcapotzalco Mexicapan, ra ngoho ra panitzin, ra bonahmu nuni ra Ecatepec,
ra mu̱di ra pa mi o̱t'e ra ngo ra mäkime ra u, ra thuhu ra Huixtocihuatl	ra mudi ra pa mi othe ra ngo ra mäkime ra u, ra thuhu ra Huixtocihuatl
ra nge'a bi mu̱ni ko ra mahuai ha ra xu̱tha nu'a to'o bi umbabi ra ji.	Rä ngä'ä bi mbeni ko rä mahua'i ha rä xuthä nu'ä to'o bi umbäbi rä hñä.
ra nyoho, bi tho ra ndä ra Nauhtla, mra thuhu ra Cohualpopocatzin.	Ra ñuhu, bi tho ra nda ra Nauhtla, mra thuhu ra Kogualpopokatzin.
unga ya ngue̱nda te ra ts'omu̱i mi bu̱'i ne mi japi da ntso̱m'i nuya macehualtin, njabu̱ mi thutuabi ya jä'i mi b'u̱i te ma za	'ñä ya ngüenda te ra ts'oni mi b'ui ne mi xapi da ntsöni nuya masehualtin, ñajü mi thuthuabi ya jä'i mi b'ui te ma za
xib'u̱ bri fádi ge nuya he mi ja nuni ra cuauhchichilco, ha Xaltocan; ge mi pttsi ya ndá.	Xib'u̱ bri fádi ge nuya he mi ja nuni ra Cuauhchichilco, ha Xaltocan; ge mi pttsi ya ndá.
xki mbo̱ni nubu̱ ra hyodi ra Cuehuecatitlan,	xki mboni nubu ra yodi ra Cuehuecatitlan,
xki thete ra Ixtlilxóchitl ne ra ku ra Cohuanacotzin ko ya he dega dänga ndä bi mu̱di da häni ra hoga ts'ofo ya evangelio,	Xki thete ra Ixtlilxóchitl ne ra ku ra Cohuanacotzin ko ya he dega dänga ndä bi mu̱di da häni ra hoga ts'ofo ya evangelio.
ya dänga ñu̱ni nsafi, ya nsafi, ya mahuai, hangu nu'u̱ gatho xki tagi mbo ha ra hñe.	Ya dänga ñu̱ni nsafi, ya nsafi, ya mahuai, hangu nu'u̱ gatho xki tagi mbo ha ra hñe.
bi o̱tuabi nu'a ra makja xki nk'ohni mra thuhu ra alonso ruiz, ge mi y'o nuni huamuxtitan (Huamuxtitlan) nuni ra hyodi guerrero.	Bi o̱tuabi nu'a ra makjä xki nk'ohni mra thuhu ra Alonso Ruiz, ge mi y'o nuni Huamuxtitán (Huamuxtitlán) nuni ra hyodi Guerrero.
di pädi xahño nuna b'e̱fi nehe yoho to'o di pädi da mpe̱fi da y'este nuya hoga do mahye̱gi ya xito, mra thuhu ra ambetz'ihuay.	Di pädi xañu nuna b'efi nehe yoho to'o di pädi da mpefi da yeste nuya hoga do mahyegi ya xito, mra thuhu ra ambetz'ihuay.
dra thoki ra nto̱de, ra ketzal dra b'e̱ nuni Coyohuacan.	Ra thoki ra nt’ot’e, ra k’etsal ra b’ë nuni Koyohuakan.
e mi r'ani dega xui ra Cihuacóatl g'ea mi zoni ne mı mafi.	E mï r’ani dega xüi ra Cihuacóatl gä mï zoni ne mï mafi.
ebu̱ bi gäi habu̱ mi to̱ge ebu̱ bi yopa ma ha ra hnini ra Cuetaxtlan,	Hñä ebu̱ bi gäi habu̱ mi to̱ge hñä ebu̱ bi yopa ma ha ra hnini ra Cuetaxtlan.
ge'a ra mu̱di ra thuhu ra Hernando, ra nge'a njabu̱ mra thuhu ra takjä ra Cortés nehe njabu̱ mra thuhu ra ndä católico ne ra ku ra Cohuanacotzin bi thutuabi ra Pedro po ra Pedro Alvarado ra nge'a ra takjä,	ge’a ra mudi ra thuhu ra Hernando, ra nge’a ñäbu mra thuhu ra takxä ra Cortés nehe ñäbu mra thuhu ra ndä católico ne ra ku ra Cohuanacotzin bi thutuabi ra Pedro po ra Pedro Alvarado ra nge’a ra takxä,
ma n'a mi b'ai nuni teotletso, habu̱ ra ñ'u̱ pa manjuäntho pa da zo̱ni nuni ra peñón (Tepetzinco).	Ma n'a mi b'ai nuni teotletso, habu̱ ra ñ'u̱ pa manxuanto pa da zo̱ni nuni ra peñón (Tepetzinco).
"mi tso̱ho̱ getbu̱ ra fu̱nga t'o̱ho̱, habu̱ mi thutuabi ""tajón ra nxu̱ni, njabu̱ bi hutuabi ya ndeznä ya b'e̱hnanoya bi pe̱hni ra ts'e̱y'e̱hmu, mi gu̱t'a ra ñ'u ra Tzihuacpopocatzin, bi bo̱nga ha ra ñ'u."	"Mi tso̱ho̱ getbu̱ ra fu̱nga t'o̱ho̱, habu̱ mi thutuabi ""tajón ra nxu̱ni, njabu̱ bi hutuabi ya ndeznä ya b'e̱hnanoya bi pe̱hni ra ts'e̱y'e̱hmu, mi gu̱t'a ra ñ'u ra Tzihuacpopocatzin, bi bo̱nga ha ra ñ'u."
mra ku ra Cacamatzin mra bo̱nahmu nuni Tetzcoco mri ñ'oui va jä'i mi y'o mpaha.	Mä ku ra Cacamatzin mä mbó̱nahmu nuni Tetzcoco mri ñ'úi va jä'i mi y'o mpaha.
n'a ra nto̱de dega chalchihuite, xi m'et'e dega ze̱ka do, nehe mi pe̱tsi n'a ra tsant'i de ga k'astaboja.	N’a ra nt’odi dega chalchihuite, xi m’et’e dega zeka do, nehe mi pe̱tsi n’a ra tsant’i dega k’astaboja.
ne ndunthi ya ambetz'ihuay ne mar'a hoga do mi pe̱tsi ra mu'ui:	Nde̱ ntho̱thi ya ambets'i hñu̱hai ne mar'a hoga do mi pe̱tsi ra mu'ui.
nehe n'a ya the̱sthi dega mboťahuaido.	Nehe n’a ya the̱sthi dega mbo̱thahuaido.
nuna bi o̱t'a ra ntso̱m'i ra nge'a nehe nuya ya b'e̱datsi bi tsini ko ra Cortés ne ra Cohuanacotzin ne ra ixtlilxóchitl xki nsofo pa ra ixtlilxóchitl da gu̱ka ya jä'i ge mi zu ya hyodi, njabu̱ mi pe̱hna ajuä da t'o̱t'e.	Nuna bi o̱t'a ra ntso̱m'i ra nge'a nehe nuya ya b'e̱datsi bi tsini ko ra Cortés ne ra Cohuanacotzin ne ra Ixtlilxóchitl xki nsofo pa ra Ixtlilxóchitl da gu̱ka ya jä'i ge mi zu ya hyodi, njabu̱ mi pe̱hna ajuä da t'o̱t'e.
nuna nt'o̱t'e bi nthandi xa nts'ogi njabu̱ bri thutuabi, bi ena ge mra nzu̱te ko ma m'u̱hai ra nzu̱te ne mi thutsuabi ko ya mpe̱bi dega mabagì, habu̱ hmä ge n'a di ge'u̱ bi y'e̱nga n'a ra do, ko nge'a bi hyo, nu'u̱ mar'a ya b'e̱go ge mä ge nu'u̱ se̱he̱ ya ñämfo̱ bi hyo bi mu̱tu'a n'a ra mahuai ha ri ngati bi mu̱tuabi n'a ra nzu̱ni.	nuna nt’ot’e bi nthandi xa nts’ogi njabu bri thutuabi, bi ena ge mra nzute ko ma m’uhai ra nzute ne mi thutsuabi ko ya mpefi dega mabagì, habu hmä ge n’a di ge’u bi y’enga n’a ra do, ko nge’a bi hyo, nu’u mar’a ya b’ego ge mä ge nu’u sehe ya ñämfo bi hyo bi mutu’a n’a ra mahuai ha ri ngati bi mutuabi n’a ra nzuni.
ra Cuauhtémoc, Tlacotzin, ra Cihuacóatl, Oquiztzin, Panitzin, Motelhuihtzin; nuna bi sofo ra Cortés nuni Coyoacan, nu'u̱ to'o mi pädi yoho ya hñäki ngu'a ra jerónimo aguilar ra malintzin.	Ra Cuauhtémoc, Tlacotzin, ra Cihuacóatl, Oquiztzin, Panitzin, Motelhuihtzin; nuna bi sofo ra Cortés nuni Coyoacan, nu'u̱ to'o mi pädi yoho ya hñäki ngu ra Jerónimo Aguilar ra Malintzin.
t'ena ge ya macehual [ya jä'i b'u̱i ha ra hyoya]	T’ëna ge ya Macehual [ya jä’i b’ui ha ra hyoya]
"xki thokuabi nuya hotho ts'ints'u̱ mra thuhu ra ""tlauhquecho"" ne “tzinitzcan zacuan"","	"Xki thokua̱bi nuya hoto ts'ints'u̱ mra thuhu ra ""tlauhquecho"" ne ""tzinitzcan zacuan""."
-¿te be'a gi mä nu'i Cihuacóatl?	-¿Te bädi gi mä ñuhi Cihuacóatl?
bi k'ahni ko ya dänga ñuni nzafi ne bi thetse ko ya makahuai nuya otomi geb'u̱ bi japi bi b'e̱di, bi mä nuyu̱:	Bi k’ahni ko ya dänga ñuni nzäfi ne bi thetse ko ya makahuai nuya hñä gebu̱ bi japi bi b’e̱di, bi mä ñu̱hü:
da thuts'i ya njot'ihñä ( )	da thuts’i ya ñot’ihñä ( )
da umbabihe te da zi, da japabihe ndunthi ma zu.	Ra umbabihe te ra zi, ra hapabihe ndunthi ma hñu.
ebu̱ bi mä nuna b'e̱fi xa thoki xahño bi johya ra ts'e̱y'e̱hmu.	Ebo̱ bi mä nuna b'e̱fi xa thoki xañu bi johya ra ts'e̱y'e̱hmu.
"fernando alva ixtlilxóchitl, xiii njändahmä ""ra ñ'ehe ya ñämfo̱ ne ra mu̱di ra hoga ts'ofo ra evangelio."""	"Fernando Alva Ixtlilxóchitl, XIII ñändähmä ""ra ñähe ya ñämfo̱ ne ra mudi ra hoga ts'ofo ra evangelio."""
ga juatihu̱ nu'a huts'i njani, ya ts'ojä'i, ra carranza, ge xa o̱t'a ya ts'okuate pa gekagihu̱; ga o̱t'e da nja ra ts'e̱di ma munts' ne njabu̱ ga tsu̱dihu̱ da nja nu'a ra hoga tsu̱tui, da nja ra hai, ra hñegi ne ra hoga ts'u̱tui;	Ga juatihu̱ nu'a hutsi̱ njani, ya ts'ojä'i, ra karransa, ge xa o̱t'a ya ts'okuate pa gekagihu̱; ga o̱t'e da nja ra ts'e̱di ma munts'i ne njabu̱ ga tsu̱dihu̱ da nja nu'a ra hoga tsu̱tui, da nja ra hai, ra hñägi ne ra hoga ts'u̱tui.
gatho ya hyoyajä'i mi b'u̱i ha ra hnini bi handi.	gatho ya hyoya jä’i mi b’ui ha ra hnini bi handi.
ha bi häni ra ñ'udi, ma jä'ihu̱ bi ent'i gatho mahye̱gi nuya nzu̱te	Ha bi häni ra ñ'udi, ma jä'i hñäki bi ent'i gatho mahye̱gi nuya nzute.
ha n'aa nza̱tho xudi ra pale berto, bi bo̱ni nda hyonga te nda nzimxidi ngetho nda zi ya hme hyaxtho mi u̱xa ya u, ua ngu mi nzäi mi nkahui yá hme nuya txuju̱ xa hogi ha nuya 'bomuha̱i nts'ät'i, nt'o̱kuä;	Ha n’á nza̱tho xudi ra pale Berto, bí bo̱ni nda hyonga te nda nzimxidi ngetho nda zi ya hme hyaxtho mi u̱xa ya u, ua ngu mi nzäi mi nkahui yá hme nuya txuju̱ xa hogi ha nuya 'bomuha̱i nts’ät’i, nt’o̱kuä.
ha nubia di ndäki, di ndändiñähmu, di ma ga ts'u̱tsa'i ri y'e, ga ndäne'i ra nge'a nu'a'i ma makjahe, ra bartolomé lópez, nub'u̱ mi njuäni ma b'e̱hña inbi njuäni ha nubu̱ mi xaxi pa da o̱t'a ya tso̱mfen	ha nubya di ndäki, di ndändiñähmu, di ma ga ts'u̱tsa'i ri y'e, ga ndäne'i ra nge'a nu'a'i ma makjahe, ra bartolomé lópez, nub'u̱ mi njuäni ma b'e̱hña inbi njuäni ha nubu̱ mi xaxi pa da o̱t'a ya tso̱mfen
ha ya t'u̱ka ze̱ki thuts'i n'a tu̱kitho nuna thogi ge bi huxa ra fernando alva ixtlilxóchitl, nu'a b'e̱tsi ra xiiii njondahmä.	Ha ya t'uka zeki thuts'i n'a tukitho nuna thogi ge bi huxa ra Fernando Alva Ixtlilxóchitl, nu'a b'etsi ra xiiii ñondahmä.
habu̱ ga ju̱he nuyu̱ (ya tenochcas) te gi honihu̱?	Häbu̱ ga juhä nu̱yu̱ (ya tenochcas) te gi honi?
ham'u̱ gatho ya juän'ahmä ge nuua xa ze̱ti ri ñ'ehe dige'a ya noya ya mu̱dimehai ha ra hñä ya ndeznä, nuna thuhu ri uni inga se̱he̱ ra n'atsanoya pa da fädi ra hñämfo̱, ingi ri me̱udi dige'a ra hmä fu̱oti dige'a nuna ra hñäki ra netzahualcoyotl. ne ra cuauhtémoc.	jam’bu̱ gato ya xüän’ahmä ge nuwa xa zäti ri ñ’ehe dige’a ya noya ya mu̱dimehai ha ra hñä ya ndeznä, nuna thuhu ri uni inga sähe̱ ra n’atsanoya pa da fädi ra hñämfo̱, ingi ri me̱udi dige’a ra hmä fu̱oti dige’a nuna ra hñäki ra netzahualcoyotl. ne ra cuauhtémoc.
mi hneki ngu ma jä'ihu̱ ngabu̱ mri hneki.	Mi hneki ngu ma jä'iho̱ ngabu̱ mri hneki.
ndunthi bri johya, bri thuxpabi gatho nu'a mi o̱t'abi ra b'edi, ko nge'u̱ bi m'u̱i ne mi t'umbabi ya t'ixu:	Ndunthi bri johya, bri thuxpabi gatho nu'a mi o̱t'abi ra b'edi, ko nge'u̱ bi m'u̱i ne mi t'umbabi ya t'ixu:
ngu mra me̱ti, nu'a r'a hyodi, habu mi y'o, n'a ngu n'a mi johya mi mfe̱m'a xinxi xi mi johya ya ndäte, mi thede n'a ngu n'a mi hñu̱fi ne mi fe̱m'a ya xinxi: xi mi b'u̱i mpaha.	Ngu mra me̱ti, nu'a r'a hyodi, habu mi y'o, n'a ngu n'a mi johya mi mfe̱m'a xinxi xi mi johya ya ndäte, mi thede n'a ngu n'a mi hñu̱fi ne mi fe̱m'a ya xinxi: xi mi b'u̱i mpaha.
njabu̱ ri ñ'ehe ya je̱ya inda m'e̱di, inda mpumfri, ga nzäi ga pe̱tsi nugagihu̱ ha ma mfenihu̱, ga pe̱tsi nugagihu̱, ra bätsi dige'u̱, ya b'e̱to, ya ntsaniku, ya mbänga b'e̱to ne to'o dra ñ'epu̱, to'o mahye̱gigihu̱, ma jihu̱, ya ku̱hu̱.	ñajbu̱ ri ñähe ya jäya nda mädi, nda mpumfri, ga nzäi ga pëtsi nugagihu̱ ha ma mfenihu̱, ga pëtsi nugagihu̱, ra bätsi dige'u̱, ya bëto, ya ntsaniku, ya mbänga bëto ne to'o ra ñäpu̱, to'o mahye̱gigihu̱, ma jihu̱, ya ku̱hu̱.
nu xä oth'u̱, ma gä ñ'jähu̱	Nu xä oth'u, ma gä ñ'jähu.
nuga̱ xi di ne'i, hindi pädi hanja...	Nuga̱ xi di ne'i, hñäki pädi hanxa...
num'u̱ di johyahu̱, nkuehu̱, nts'o̱mihu̱, tsuhu ne pa da t'o̱xkähu̱ di hohñu̱ nu ya nt'u̱i xi di 'yoohu̱ (¡!). nuya da nt'ot'i ko ra dänt'ot'í	ñum'ú di johyahú, nkúehú, nts'omhíhú, tsúhú ne pa da t'óxkahú di hohñú nu ya nt'úi xi di 'yóhú (¡!). nuya da nt'ot'i ko ra dänt'ot'í
nuna bi johya ha ra mabagi,	Nuna bi yohya hã ra mabagi,
nuya hñu o gohoya pa bi b'u̱i nubu̱ bi xitsuabi ra jäpadehe ndunthi ya jä'i, ngu xa t'ena.	Nuya hñu o gohoya pa bi b’ui nubu bi xitsuabi ra jäpadehe ndunthi ya jä’i, ngu xa t’ena.
nuya tsat'io mi b'et'o, mi gu̱t'a ra ñ'u, mi teni, ya xiñu mi ju̱ts'i pa mañä, xi mi pähä gatho mi handi mi nest'ihi: mi tu̱ta ya jihni	Nuya tsät’iö mi b’ët’o, mi güthä ra ñ’ü, mi tëni, ya xiñu mi hñuts’i pa mañä, xi mi päjä gatho mi handi mi nëst’ihi: mi thüta ya hñähñi.
pe, nu'i ndada nu'i ma t'ek'ei ra makja, nub'u̱ nu'i ingi zugagihe, ¿hanja, nuua, ra hyo di ge'a, ga tsogi nubu̱ [nu'a ma b'e̱hña]?	Pe, nu'i ndada nu'i ma t'ek'ei ra makxa, nub'u̱ nu'i ingi zugagihe, ¿hanja, nuwa, ra hyo di ge'a, ga tsogi nubu̱ [nu'a ma b'e̱hña]?
r'a ya jä'i mi b'u̱i ha ra ngumi ja nunu ha ra hnini ri manjuäntho pa da tsoni nubu̱ ra amáxac,	r'a ya jä'i mi b'ui ha ra ngumi ya nunu ha ra hnini ri manxuanto pa da tsoni nubu ra amáxac,
ra nge'a di o̱t'a nuna noya ra ts'u̱tui ne gatho to'o da guat'a ha ma hyohe, nu'u̱ to'o da ne, da me̱tsi n'a ra hoga m'u̱i ne da m'u̱i manjuänthä. ha nubu̱ xa mabu̱ ma noya ge di pe̱tsi ra tsa, dega hoga jä'i ne dega hogat'o̱t'antuhni	ra nge’a di o̱t’a nuna noya ra ts’u̱tui ne gatho to’o da guat’a ha ma hyohe, nu’u̱ to’o da ne, da me̱tsi n’a ra hoga m’u̱i ne da m’u̱i manjuänthä. ha nubu̱ xa mabu̱ ma noya ge di pe̱tsi ra tsa, dega hoga jä’i ne dega hogat’o̱t’antuhni
ra ngehna nuna pa bi ma n'a ra ñ'u manjuäntho.	ra ngehna nuna pa bi ma n’a ra ñ’u manjuänt’o.
ra nhñu ne ra ngästsi ra b'ist'ofo di huts'ihu̱ ha nuna ze̱ki b'ist'ofo, ri ñ'ehe ra vii njondahmä ra chimalpain,	ra ñäñu ne ra ngätsi ra b'ist'ofo di hutsi̱hu̱ ha nuna ze̱ki b'ist'ofo, ri ñähe ra vii njondahmä ra chimalpain,
ra nthädi ra cuitlahuacatzin bi ena ge ina da o̱t'e nuya bi b'e̱pabi ya nso̱ho̱jä'i,	Ra nt'ädi ra Cuitlahuacatzin bi ena ge ina da o̱t'e nuya bi b'e̱pabi ya ntso̱ho̱jä'i.
ra nyoho nu'a mi zu ra tepoztlan; ra nhñu ra me tizatlan, ra njoho mi ñ'ehe nuni huehuetlan ne ra nku̱ta mra dänga mictlan.	Ra ñuhu nu'a mi zu ra Tepotzotlán; ra ñuhu ra me Tizatlán, ra ñuhu mi ñ'ehe nuni Huehuetlán ne ra nkuta mra dänga Mictlán.
ri ñ'udi xahño nubia hanja beni ya metlaxcala bi do̱m'i mpaha nuya nso̱ho̱ jä'i.	Ri ñudi xañu Nubia hñäjä b'eni ya Metlaxcala bi do̱mi mpaha nuya nso̱ho̱ jä'i.
t'ena ge inbi unga mfädi pa gatho ya jä'i mi ñ'oui, ge nuna ndada ra marqués da ñ'ehe dra hmu ha ma haihe, da ja me̱ti nu'a di pe̱tsihe nehe dra jakagihe ga mpe̱fihe ra hai ge bi umbabi o bi hänbabi ya hoga hai ya n'añ'o hnini.	T’ena ge inbi ’na mfädi pa gatho ya jä’i mi ñ’oui, ge nuna ndada ra marqués da ñ’ehe ra hmu ha ma haihe, da ja me̱ti nu’a di pe̱tsihe nehe ra jakagihe ga mpe̱fihe ra hai ge bi umbabi o bi hänbabi ya hoga hai ya n’añ’o hnini.
xi mi taxki ra ñ'u, imbi tsa da r'anga n'a, ho̱nse̱he̱ mi taxka n'a ha ra bo̱hai. ya y'ofadi mi ju̱t'atho.	Xi mi taxki ra ñ'ú, imbi tsa da r'anga n'a, hönsehe mi taxka n'a ha ra bohái. Ya y'ofadi mi jut'atho.
ya dänga mfu̱nga bo̱jä bi ntho, bi kot'i ko ya mahjuai, mi zu̱m'i nehe ko ya t'e̱nga ts'u̱t'abo̱ja.	Ya dänga mfu̱nga bo̱jä bi ntho, bi kot'i ko ya mahjuai, mi zu̱m'i nehe ko ya t'e̱nga ts'u̱t'abo̱ja.
ya r'atsanoya ra sahagún mi mä hanja mi yopa tsini. ya ndeznä bi nkohi inda ñ'udi. mi hatatho pa bi mu̱di ra ntuhni	Ya r'atsanoya ra Sahagún mi mä hanxa mi yopa ts'ini. Ya ndeznä bi nkohi inda ñ'udi. Mi hatatho pa bi mu̱di ra ntuhni.
ya zi b'e̱hña mi ägi ha ya b'a ne ha ya ngo̱de, nuya ñ'o̱ho̱ mbo ha ya ne, ha ya njom'ahudi.	Ya zi bä̱hna mi ägi ha ya bä ne ha ya ngode, nuya ñ’o̱hó mbo ha ya ne, ha ya ñom’ahudi.
bi boxro xi 'be̱ts'ina, bido'u̱ ro 'yu̱ni 'na, xi bi bo̱x ro hjua 'na, bido'u̱ ro ts'ii 'na, xi bo̱xro ts'äre 'na. ge'bu̱ go min pu̱n doja 'na.	Bi boxro xi 'be̱ts'ina, bido'u̱ ro 'yu̱ni 'na, xi bi bo̱x ro hñua 'na, bido'u̱ ro ts'ii 'na, xi bo̱xro ts'äre 'na. Ge'bu̱ go min pu̱n doja 'na.
bi ma manjuäntho habu̱ mi b'u̱i ra ts'e̱y'e̱hmu bi xipabi;	Bi ma manxuanto habu̱ mi b'u̱i ra ts'e̱y'e̱hmu bi xipabi.
bri juahni po nuya dra hmu.	B'ri xwäni po nuya ra hñu.
di to̱m'ihe ra ñ'ethi pa nugagihe, n'a ra pa ngu ma n'a ra pa thogi nekagihe di huadihe ra nge'a indi tse̱tihe nuna b'u̱i t'o̱t'e ko ngekagihe man'año ya ntho, t'e̱nts'igihe thi ma haihe ma me̱tihe, ju̱kagihe ga mpe̱fihe ndunthi, b'e̱kagihe ga jut'ihe xdunthi ya boja, n'a ngu n'a ra pa nuna njut'i di o̱t'ehe man'a te ma thaihe di tuhe.	Di tom'ihe ra ñ'ethi pa nugagihe, n'a ra pa ngu ma n'a ra pa thogi nehkagihe di huadihe ra nge'a indi tse̱tihe nuna b'u̱i t'o̱t'e ko ngehkagihe man'año ya ntho, t'e̱nts'igihe thi ma haihe ma me̱tihe, juhkagihe ga mpe̱fihe ndunthi, b'e̱hkagihe ga jut'ihe xdunthi ya boja, n'a ngu n'a ra pa nuna njut'i di o̱t'ehe man'a te ma thaihe di tuhe.
gatho nuna hai ha nuna r'ayo ximhai njabu̱ bi thutuabi nuya nso̱ho̱jä'i inbi tsa bi thutuabi man'a ra thuhu.	gatho nuna hai ha nuna ra'yo ximhai njabu̱ bi thutuabi nuya nso̱ho̱jä'i inbi tsa bi thutuabi man'a ra thuhu.
ha mi tso nde, bi mu̱di bi nja n'a ra hneki ngu njagihu̱ dega jä'i, bi t'ot'e ra b'ai ngu dega jä'i,	Ja mi tso nde, bi mudi bi nja n'a ra hneki ngu njagihu dega jä'i, bi t'ot'e ra b'ai ngu dega jä'i,
ma bo̱nahmu'ihe: nuna b'e̱fi ga tsokagihe sta juatihe gatho: gi nuti nuua, xa hño bo̱nahmu.	Ma mbónahmuihe: nuna béfi ga tsokakihi sta juatihe gatho: gi nut'i nuha, xa hñu mbónahmu.
mi mä dega ts'e̱dira hñä tso̱pu da ts'o̱ho̱bu nuya nzo̱ho̱jä'i ga handihu̱ te ma ts'e̱di pe̱tsi, ra nge'a ma ajuä ra quetzalcohuatl b'u̱i nuua ko ngekagihu̱,	Mi ma dega ts'edirä hñä tsopuda ts'ohobu nuya nzohöjä'i ga handi hute ma ts'edi pëtsi, ra nge'a ma ajuä ra Quetzalcoatl b'ui nuä ko ngekagihu.
ne ya nt'u̱i, hanja di thuts'i ya nt'ofo, njap'u̱ nehe mä 'ra ya mpeu̱i da fats'i di nt'ot'i ra hñähñu	Ne ya nt’ui, hanxa di thuts’i ya nt’ofo, ñäpä nehe mä ra ya mpeui da fätsi di nt’ot’i ra hñähñu.
nub'u̱ nu'i ingi japi da bo̱nga nu'a ra makja ha nu'a ra hnini, ¿hanja ra yotui, ga tso̱gi nubu̱ ma b'e̱hña? o̱t'a r'ato ya je̱ya bi mu̱di [ra makja ra bartolomé lópez]	Nub'ú nu'i ingi japi da bo̱nga nu'a ra makxa ha nu'a ra hnini, ¿hanja ra yotui, ga tso̱gi nubu̱ ma b'e̱hña? O̱t'a r'ato ya je̱ya bi mu̱di [ra makxa ra Bartolomé López]
pa ga b'u̱i mpaha ne ga o̱t'e n'a ra njondahmä gatho nu'a ga handi.	Pa ga b’ui mpaha ne ga o̱t’e n’a ra ñu’ndähmä gatho nu’a ga handi.
r'a nuna mi nthandi ngu nu'a ma thänjuahu̱ (ychtlilmatli), xi mra nts'o, mi kuet'e ha ya ngo̱,	ra nuna mi nt'andi ngu nu'a ma thäñuähu̱ (ychtlilmatli), xi mra nts'o, mi kuet'e ha ya ño̱,
xa zägi mpaha, nub'u̱ xa njabu̱ xa japabi ma zu ne inte xa t'o̱tuabi nub'u̱ inda japi xa po̱ho̱ bi ya kue̱ ra nge'a ya jä'i xi mra no̱t'e ne mra hyotejä'i,	Ja zäki mpaha, nu'b'ü ja ñäbu ja hapabi ma zu ne inte ja t'ot'obi nu'b'ü nda häpi ja poho bi ya kue ra nge'a ya jä'i xi mra not'e ne mra hyotejä'i.
y'o, ri ma ne gi xipabihu̱ ya metlaxcala ge ma r'a ya me̱ti jä'i ne ri ajuähu̱, ge nu'a ga mä ge xa ehe nuua ma haihu̱, ge di umbabihe ma nthädihe.	Ño, ri ma ne gi xipabihño ya Metlaxcala ge ma ra ya me̱ti jä'i ne ri ajuähu̱, ge nu'a ga mä ge xa ehe nu'a ma haihu̱, ge di umbabihe ma nthädihe.
¿te da o̱t'e ma jä'ihu̱ sta b'e̱dihu̱?	¿Te da o̱t'e ma jä'i̱hü̱ sta b'e̱di̱hü̱?
-da ts'iua:... ri ñ'ehe ge'a ma njueih'u̱. da o̱t'ehe ya ñ'o̱te ko ya he̱m'i, ya ñ'o̱t'ehe ko ya ntuts'i. da o̱ts'e̱ ra b'e̱na noya.	-Da ts'iwa:... ri ñähe geä ma ñu̱hü. Da o̱t'ehe ya ñ'o̱te ko ya he̱m'i, ya ñ'o̱t'ehe ko ya nt'uts'i. Da o̱ts'e̱ ra bä̱na noya.
-dom'i ma ajuähu̱ ge inda yu̱t'a ha ma nguhu̱ nuhu̱ to'o e̱nts'i pa thi ne da hokuabi ra honanhyo nub'u̱ sta ne da hyoki ya inda za.	-Dom'i ma ajuähu̱ ge hñä yu̱t'a ha ma nguhu̱ nuhu̱ to'o e̱nts'i pa ti ne da hokuabi ra honanhyo nu'b'u̱ sta ne da hyoki ya hñä za.
-o̱t'a ra mäte gi o̱dehu̱, ja gi b'ai nuuahu̱. mont'a ya ngo ajuä; ri juat'i ra ngo ga tsunda ma ajuähe.	-’ot’a ra mäte gi othehu, ja gi b’á’i nuähu. mont’a ya ngo ajuä; ri juat’i ra ngo ga ts’unda ma ajuähe.
-xa hño, di b'u̱ihe njamädihe.	Ja hñu, di b’uihe ñamädihe.
-¿nguande njabu̱ ga mäu gra juähu̱?	¿Nguande ñäbu̱ ga mäu gra juähu̱?
-ñ'emabagi, ya gabida, ya jä'ihu̱ gi pädi ra ntuni ra mem'onda ba ehehu̱ ga te̱nihu̱ma nzu̱tehu̱. ko ya mätsa mi te̱he̱, ko ya bu̱'bai ko ngatho ra ts'e̱di mi te̱he̱ ra ñ'u.	Ñ'emabaxi, ya gabida, ya jä'iho gi pädi ra nt'uni ra mem'onda ba eheho ga te̱niho nzu̱teho. Ko ya mätsa mi te̱he̱, ko ya bu̱'bai ko ngatho ra ts'e̱di mi te̱he̱ ra ñ'u.
bi tse̱ti nuna ngot'i ra m'onda, ngu pede ra dänga b'ede, ya k'oi ne ya njändahmä, ngu nu'a ra hmä ra alonso axayaca, goho n'ate ma pa bi nzo̱t'e nuna pa.	Bi tse̱ti nuna ngot'i ra m'onda, ngu pe̱de ra dänga b'ede, ya k'oi ne ya ñänt'ahmä, ngu nu'a ra hmä ra Alonso Axayaca, goho n'ate ma pa bi nzot'e nuna pa.
into y'o manjuäntho, into pa ri nektho.	´ñätho y'o manxuanto, ´ñätho pa ri nexto.
nub'u̱ ndi umbabihe ma njut'ihe xki nzäi ndi da'ihe, mi adi n'a tu̱ki nehe nub'u̱ ndi unihe ya k'astaboja mi häni made n'a tu̱ki [...]	Nub'u̱ ndi umbabihe ma njut'ihe xki nzäi ndi da'ihe, mi adi n'a tu̱ki nehe nub'u̱ ndi unihe ya k'astaboja mi häni made n'a tu̱ki [...]
ya miñ'o ko ngehna hmä ri johya,	Ya miñ'o ko ngehna hmä ri johya.
bi tso̱hso̱ ra ngo ma ajuähu̱: nubia da fu̱di da guadi ra r'e̱t'a ra pa.	Bi tso̱hso̱ ra ngo ma aywähu̱: Nubia da fudi da gwadi ra r'e̱t'a ra pa.
