Input	Result
"-pasadores: ""ya nts'äza xi mra nts'u̱t'i mi t'e̱ni ko n'a ra t'e̱nga ts'u̱t'a bo̱kja mi tjutuabi ra ballesta""."	Ya nts'äza xi mra nts'u̱t'i mi t'e̱ni ko n'a ra t'e̱nga ts'u̱t'a bo̱kja mi tjutuabi ra ballesta.
cantares mexicanos, biblioteca nacional de méxico, ya nt'ofo 1628 bis, folio 16 v.	Cantares Mexicanos, Biblioteca Nacional de México, ya nt’otho 1628 bis, folio 16 v.
"ebu̱ bi bo̱ni, bi meui nuni nonohualco, ja ra ngu ra b'ongui jabu̱ ra gabida ne ra malintzin ne ""ra jyadi"" (alvarado) ne ra sandoval."	"Ebo̱ bi bo̱ni, bi meui nuni nonohualco, ja ra ngu ra b'ongui jabu̱ ra gabida ne ra Malintzin ne ""ra Jyadi"" (Alvarado) ne ra Sandoval."
gi jandi ra nt'ofo ra tjuju ra crónicas de la conquista	gi jandi ra nt’ofo ra t’ot’u ra crónicas de la conquista
guzmán. ja ya je̱m'i b'e̱tsa kje̱ya manteb'u̱ di ge nuua m'onda ne ya jyo, nu'a ra jmä ra 12-conejo (1530) ge xa jmä ge xibú bi yut'i ja ra culhuacan ya ndeznä, nda pablo xochiquetzin, motelchiuhtzin ne ra guzman.	Guzmán. Ja ya jämi bët'a këya manteb'u di ge nuwa m'onda ne ya jyo, nu'a ra jmä ra 12-Conejo (1530) ge xa jmä ge xibú bi yut'i ja ra Culhuacan ya ndeznä, nda Pablo Xochiquetzin, Motelchiuhtzin ne ra Guzmán.
ja ga ñ'udiju̱ ra nt'ofo ya ñämfo̱ po ra ntjuts'i ra doctor garibay,	Xa ga ñ'udi̱ju̱ ra nt'ofo ya ñämfo̱ po̱ ra nt'uts'i ra doctor Garibay.
ja nu'a jyodi nubia tjutuabi ra san martin.	Xa nu'ä yodi nu'bya thuthäbi ra San Martín.
je̱mi unga mfädi ja ra t'u̱ka jnini jabu̱ b'u̱i ya kjä'i teni ra división ra arenas, 27 ra abril ra kje̱ya 1918, ra m'ets'a je̱m'i ra zapata, b'e̱tsi ja ra universidad nacional autónoma de méxico, expediente 29.	Jämi unga mfädi ja ra t'uka jnini jabu b'ui ya kjä'i teni ra división ra arenas, 27 ra abril ra kje̱ya 1918, ra m'ets'a jämi ra zapata, b'etsi ja ra universidad nacional autónoma de méxico, expediente 29.
"m'e̱fa ja ra jñuti bri tjätuabi na ra jñe xki tagiri mo̱te, neje bri kjom'a ra xu̱tja ko n'a ra t'axa dutu mra tjujuu ra ""campanillante""."	"M'efa ha ra ñuti hñä t'ätuabi na ra ñä xki tagi mo̱te, neje hñä kom'a ra xutja ko n'a ra t'axa dutu mra tjuju ra ""campanillante""."
ma dada'ije gra ts'u̱tui, di ne gi pädi ge ma me̱t'o instä tjogije nuna tjogi gatjo ya mapa xki r'ani, bi kjuat'i ko ngeke nu̱'u ri b'e̱go, ri me̱fi ya ñämfo̱, ra nge'a makjuäni ra hernando cortés ra ndä gabida,	Ma dadai xe gra ts'utui, di ne gi pädi ge ma met'o instä tjogije nuna tjogi gatjo ya mapa xki r'ani, bi kjuat'i ko ngeke nu'u ri b'ego, ri mefi ya ñämfo, ra nge'a makjuäni ra Hernando Cortés ra ndä gabida.
mi b'u̱i ya mu̱dimejai mi ñä ra ndeznä ne jabu̱ ra jnini dige'a gatjo ra nxiki m'onda ngu r'a ya yaqui b'u̱i nuni sonora ne ya maya ri ñ'eje nuni yucatán ra nge bi guat'i ja ra tujni bi nkja nuua m'onda fädi ko ra tjuju ra revolución mexicana ya kje̱ya 1910-1919.	Mi b'ui ya mu̱dimehai mi ñä ra ndezna ne ja̱bu̱ ra jnini digea gatjo ra nxiki m'onda ngu ra ya ya̱ki b'ui nuni Sonora ne ya maya ri ñ'eje nuni Yucatán ra nge bi guat'i ja ra tujni bi nkja nu̱a m'onda fädi ko ra tjuju ra Revolución Mexicana ya kje̱ya 1910-1919.
mi fo̱tuabi ya ts'u̱tnibo̱kja mi tjutuabi ya jñämfo̱ ra pasadores neje ya bo̱zna ko ya nzafi.	Mi fotuabi ya ts'utnibokjä mi tjutuabi ya ñämfo ra pasadores neje ya bozna ko ya nzafi.
n'a nt'udi di ge'a nuya ntjoki bri t'o̱t'e ja ya jñä ya ndeznä ra ngätsi ra ntjebe nkje̱ya ra r'e̱t'a ma gu̱to (s. xix), r'a ya jnini ngu ra xicontepec (villa juárez) nuna jyodi koji nuni puebla.	N'a nt'udi di ge'a nuya nt'oki bri t'ot'e ja ya jñä ya ndeznä ra ngätsi ra nt'ebe nkje̱ya ra r'et'a ma guto (s. xix), r'a ya jnini ngu ra Xicontepec (Villa Juárez) nuna jyodi koji nuni Puebla.
"n'a ra t'axa dutu mi pe̱tsi ya k'oi ra ixki, nuna mra tjuju jñämfo̱ ""campaneante resonador""."	"N'a ra t'axa duthu mi pe̱tsi ya k'oi ra ixki, nuna mra tjuju ñämfo̱ ""kampaneante resonador""."
ne ri mpe̱fi ja ra dängan gu nt'udi ra tjuju ra facultad de estudios superiores, acatlán, unam,	Ne rï mpefi ya ra dängandë go nt’udi ra t’utju ra Facultad de Estudios Superiores, Acatlán, UNAM.
ntjandi gatjo nu'a ra munts'i ra tjuju jñämfo̱ ra globalización ge 'a po̱ts'e dega nest'iji, nuna y'o̱te to̱m'i da nkja ra ntjo̱mäte.	Nt'andi ga̱tho nu'a ra mints'i ra t'utju ñämfo̱ ra globalización ge 'a po̱ts'e dega nest'iji, nuna y'o̱te to̱m'i da nkja ra ntjo̱mäte.
nu'a ma r'a ya kjä'i mi pädi nuña b'e̱fi bri b'e̱pabi xa jyoki yojo ya mpe̱fi mi fädi ko ra tjuju ra amosqueador ko ya xi ya ts'ints'u̱ xi sta jotjo, gi jutsuabi made dige'a n'a ra zänä dega k'astabokja	Nu'ä ma rä ya kjä'i mi pädi nuña b'ëfi bri b'ëpabi xa jyoki yojo ya mpëfi mi fädi ko ra tjuju ra amosqueador ko ya xi ya ts'ints'ü xi sta jotjo, gi jutsuabi made dige'a n'a ra zänä dega k'astabokjä.
"nu'a ra munts'a kjä'i bi te̱ni bi zipabi man'a ya b'ede, mi t'ena ge ya kjä'i xki b'u̱i nubu̱ inbi pe̱tsi ra ts'e̱di nu'a mi mä pe m'e̱fa bi kjapi bi nxaxni ya tsu̱tui ne n'a ra diputado mi pe̱tsi ra mfeni xki kot'i mra tjuju ra josé maría lozano, bi y'onga ra jmä pa mar'a ya ñ'oui bi nxanxi: ""ri mo̱te ra tjits'i mi udi ra emiliano zapata, neje bri fädi ngu ra atila nuna bri nkju̱tsi [...] nu'a bi fädi ngu mi je̱gi ya b'e̱go ne'a bi mä da uni da nkja pa gatjo, ingi kjot'i [...]"	"Nu'a ra múnthä kjä'i bi te̱ni bi zipabi man'a ya b'ede, mi t'ena ge ya kjä'i xki b'u̱i nubu̱ inbi pe̱tsi ra ts'e̱di nu'a mi mä pe m'e̱fa bi kjapi bi nxaxni ya tsu̱tui ne n'a ra diputado mi pe̱tsi ra mfeni xki kot'i mra tjuju ra José María Lozano, bi y'onga ra jmä pa mar'a ya ñ'oui bi nxanxi: ""Ri mo̱te ra tjits'i mi udi ra Emiliano Zapata, neje bri fädi ngu ra Atila nuna bri nkju̱tsi [...] nu'a bi fädi ngu mi je̱gi ya b'e̱go ne'a bi mä da uni da nkja pa gatjo, ingi kjot'i [...]"
nu'u̱ to'o ñä ra ndenzä ja r'e̱t'a ma r'at'o ya estados.	ñu'u to'o ñä ra nthe̱nthe̱ ja r'e̱t'a ma r'at'o ya estados.
nub'u̱ ri m'e̱jni ne ri b'e̱go ya ñämfo̱ bi kjuat'i ko ngekagije ne bi tso̱jo̱ ra gabida ra tjuju ra hernán cortés, maske indi pädije ge gatjo da za da o̱t'e ne xi ra nzunda maría trinidad,	Nub'ú ri m'ejni ne ri b'egó ya ñämfo̱ bi kjuat'i ko ngekagije ne bi tso̱jo̱ ra gabida ra tjuju ra Hernán Cortés, maske indi pädije ge gatjo da za da o̱t'e ne xi ra nzunda María Trinidad.
nubia, unga mfädi ja ra ñäjñu kjamädi ra universidad autónoma del estado de hidalgo.	Nubia, 'na mfädi ja ra ñäñu xkamadi ra Universidad Autónoma del Estado de Hidalgo.
nugi, ra miguel hernández ge di pe̱tsi ma ngu nuni chiyauhtzinco, ko ra t'ek'ei di udi ko nge'i, nuna m'e̱jnant'ofo di joki go tso̱n'i ko nge'i, ma t'ek'ei bo̱najmu'i nda doctor alonso ruiz, ra nk'ojnate ge gi b'ui nuua ja ra jnini ra quamochtitla.	Nugi, ra Miguel Hernández ge di pe̱tsi ma ngu nuni Chiyauhtzinco, ko ra t'ek'ei di udi ko nge'i, nuna m'e̱jnant'ofo di joki go tso̱n'i ko nge'i, ma t'ek'ei bo̱najmu'i nda Doctor Alonso Ruiz, ra nk'ojnate ge gi b'ui nuua ja ra jnini ra Quamochtitla.
nuna je̱m'i bri t'unga mfädi ko ra t'u̱ka ntjint'ant'ofo po ra marcelo díaz salas ne ra luis reyes garcía ja: tialtocan, revista de fuentes para el conocimiento de las culturas indígenas de méxico, vol. vi, 1970, b'ede ra 3, pp. 193-212.	Nuna jämi bri t'unga mfädi ko ra t'uka nt'ënt'ant'ofo po ra Marcelo Díaz Salas ne ra Luis Reyes García ja: Tialtocan, Revista de Fuentes para el Conocimiento de las Culturas Indígenas de México, vol. VI, 1970, b'ede ra 3, pp. 193-212.
"nuna jñäpi juts'i ja n'a ra je̱m'i fädi ra derecho canonigo ko ra tjuju jñämfo̱ ngu ra ""solicitación al administrar el sacramento de la confesión""."	"Nuna hñäpi hutsi ha n'a ra hëmi fadi ra derecho canónigo ko ra txuju hñämfo̱ ngu ra ""solicitación al administrar el sacramento de la confesión""."
nuna m'e̱jna nt'ofo b'e̱tsi ja ra archivo histórico nacional, madrid, documento 165. bi unga mfädi ja ra nt'ofo ya zubi po ra y'ofo ra tjuju ra arthur j. o. anderson et al.: byond the codices: the nahua view of colonial mexico, berkeley, university of california press, 1976, pp. 181-187.	Nuna m'ejna nt'ofo b'etsi ja ra archivo histórico nacional, Madrid, documento 165. Bi unga mfädi ja ra nt'ofo ya zubi po ra y'ofo ra tjuju ra Arthur J. O. Anderson et al.: Beyond the Codices: The Nahua View of Colonial Mexico, Berkeley, University of California Press, 1976, pp. 181-187.
nuna nt'ofo b'e̱tsi ja ra archivo general de indias, sevilla, audiencia de méxico 168, bi unga dra fädi po ra miguel león-portilla ja cultura en peligro, méxico, alianza editorial mexicana, 1976, pp. 102-103.	Nuna nt’ot’o b’ëtsi ha ra Archivo General de Indias, Sevilla, Audiencia de México 168, bi hñäki ra fädi po ra Miguel León-Portilla ha Cultura en Peligro, México, Alianza Editorial Mexicana, 1976, pp. 102-103.
nuna pika je̱m'i kja te mä b'e̱tsi ja ra archivo general de la nación, nuua m'onda ne kja ja ra nduntji ya jnini, njabu̱ ngu ya nzaya nuni manjyati ne mar'a ya jnini, o̱t'e gi o̱de ra jñä ra mu̱dimejai.	Nuna pika je̱m'i kja te mä b'e̱tsi ja ra Archivo General de la Nación, nuua m'onda ne kja ja ra nduntji ya jñeni, njabu̱ ngu ya nzaya nuni manjyati ne mar'a ya jñeni, o̱t'e gi o̱de ra jñä ra mu̱dimehai.
nuua t'unga yojo ya jmä, kuän'ajmä ya ndeznä ne tjuts'i ja n'a ra k'oi mä mäkjuäni ri ntje̱ui n'a ya dänga ra tju̱ajmä manteb'u̱, nuua pede nu'a gatjo ya ts'otjogi bi y'o̱t'a dega fete ra alvarado.	Nuwa t’unga yojo ya jmä, kuän’ajmä ya ndeznä ne tjuts’i ja n’a ra k’oi mä mäkjuäni ri ntje̱ui n’a ya dänga ra tju̱ajmä manteb’u̱, nuwa pede nu’a gatjo ya ts’otjogi bi y’o̱t’a dega fete ra Alvarado.
nuua ya mu̱di noya ra motolinia, ja ra mu̱di nkoji bi t'o̱t'e ko ra tjuju ra tratado tercero ra dänga b´ede ya mu̱dimejai nuua r´ayo manjyati:	Ñuu ya mödi nuya ra Motolinia, ja ra mödi nkohi bi t'ot'e ko ra txuju ra tratado tercero ra dänga b'ede ya mödimëjäi ñuu r'ayo manthiati:
"pa da t'unga mfädi gatjo nu'u̱ bi nkja, n'a di ge'u̱ ko ngu fe̱ti nu'a makjuäni mi joki mi tjutsuabi ya jnei ne ya b'ida. b'u̱i man'a ra mfädi da t'o̱t'a ra nt'udi, nu'a ra tjuju ""fe̱ta nu'a makjuäni bi nja nub'u̱ ra tsokat'o̱tamfeni (teatro de la conquista)""."	"Pa da t'unga mfädi gatjo nu'u̱ bi nkja, n'a di ge'u̱ ko ngu fe̱ti nu'a makjuäni mi joki mi tjutsuabi ya jnei ne ya b'ida. B'u̱i man'a ra mfädi da t'o̱t'a ra nt'udi, nu'a ra tjuju ""fe̱ta nu'a makjuäni bi nja nub'u̱ ra tsokat'o̱tamfeni (teatro de la conquista)""."
ra europa -mra nxika jai manteb'u̱, mi pe̱tsa n'a ra nxika b'ede-	ra Europa mra nxika ja̱i mante̱b'u̱, mi pe̱tsa n'a ra nxika b'ede.
ra fernando ramírez mä ge nuna jyodi ri nge̱pu̱ jabu̱ kja n'a ra nikja ra san fernando ne ra ermita dige'a ya mártires dige'a san hipólito,	Ra Fernando Ramírez mä ge nuna jyodi ri nge̱pu̱ jabu̱ kja n'a ra nikja ra San Fernando ne ra ermita dige'a ya mártires dige'a San Hipólito.
"ra fernando de alva ixtlilxóchitl, fernando de, xiii relación: ""ra ñ'eje ya ñämfo̱ ne ra fu̱di ra nkanfri ra evangelio""."	"Ra Fernando de Alva Ixtlilxóchitl, Fernando de, XIII Relación: ""Ra ñ'ejë ya ñämfo̱ ne ra fu̱di ra nkanfri ra evangelio""."
ra kuän'ajma ra n luz jiménez bi juts'i ra fernando horkasitas bi unga mfädi ne bi r'atsi nuña jmä), de porfirio díaz zapata, memoria nábuatl de milpa alta, méxico, unam,, instituto de investigaciones históricas, 1974, p. 105	Ra kuän'ajma ra N. Luz Jiménez, bi juts'i ra Fernando Horcasitas, bi unga mfädi ne bi r'atsi nuña jmä), de Porfirio Díaz Zapata, Memoria Náhuatl de Milpa Alta, México, UNAM, Instituto de Investigaciones Históricas, 1974, p. 105.
ra raymundo isidro alavez, bi b'u̱i'i nuni ra boxtha chico, san salvador, estado de hidalgo	Ra Raymundo Isidro Alavez, bi b’ui’i nuni ra boxtha Chico, San Salvador, Estado de Hidalgo.
ra jmä ra fundación de santo tomás ajusco, archivo general de la nación, méxico, ramo de tierras vol. 2676, expediente. 4, archivo histórico de la biblioteca nacional de antropología, colección antigua, vol. 254, fojas 259 r.- 260 v.	Ra jmä ra Fundación de Santo Tomás Ajusco, Archivo General de la Nación, México, Ramo de Tierras vol. 2676, expediente. 4, Archivo Histórico de la Biblioteca Nacional de Antropología, Colección Antigua, vol. 254, fojas 259 r.- 260 v.
ra makja mra tjuju ra toribio benavente, motolinia,	ra makjä mra thotho ra Toribio Benavente, Motolinia,
tlauhquechol: ra ts'ints'u̱ xa ntjeni pode ge'a ra flamenco o ra guacamaya, pode ge gatjo ra tje̱nga ts'ints'u̱ ne dänga.	Tlahuikecholu: ra ts'ints'u̱ ja nt'eni pode ge'a ra flamenco o ra guakamaya, pode ge gatjo ra tje̱nga ts'ints'u̱ ne dänga.
xkri tso̱ngä ngostji, kja jejni ya 'ñu; nä'ä rí ma nxamädo, ja nä'ä rí ma mäbo̱za. antes de	Xkri tso̱ngä ngostji, kja jeni ya ñu; nä'ä ri ma nxamädo, ja nä'ä ri ma mäbo̱za. Antes de
ya b'e̱go ne ya b'e̱tri di ge'a nu'a ra dänga ndä ra ndada ra tjuju ra esteban de guzmán ra nzaya di gekua m'onda, ra ndada ra hernando pimentel, ra ndada ra antonio cortés, ra ndada xuua (juan) nuna ra mecoyoacan, ra ndada pedro motecuhzoma, me ma r'a ya kuänmi (firmas).	Ya b'ëgo ne ya b'ëtri di ge'a nu'a ra dänga ndä ra ndada ra tjuju ra Esteban de Guzmán ra nzaya di gekua m'onda, ra ndada ra Hernando Pimentel, ra ndada ra Antonio Cortés, ra ndada Xuua (Juan) nuna ra Mecoyoacan, ra ndada Pedro Motecuhzoma, me ma r'a ya kuänmi (firmas).
ya kuän' ajmä xa tjogi manteb'u̱e ge xa tjäst'i nu'a gatjo ra ntjandi to'o bi b'e̱di ge xa pu̱ngajñä nuna jmä getbu̱ n'ate ya jñäki ge ñä ya nso̱jo̱ jñäki ne xa y'oni nuna nt'ofo neje ja ra jñäki yazi xada kjä'i , ge'a nuna jñäki fadi ja ra jñämfo ko ra tjuju ra sistema braile.	Ya kuänʔ ajmä xa tjogi mantebʔe ge xa tjästʔi nuʔa gatjo ra ntjandi toʔo bi bʔedi ge xa pʔungajñä nuna jmä getbʔu nʔate ya jñäki ge ñä ya nsöjö jñäki ne xa yʔoni nuna ntʔofo neje ja ra jñäki yazi xada kjäʔi, geʔa nuna jñäki fadi ja ra jñämfo ko ra tjuju ra sistema braile.
ya r'atsanoya ra sahagán, ndoxkjua k'oi florentino, lib. xii, caps. xxix-xli (versión de ángel ma. garibay k.).	Ya r'atsanoya ra Sahagán, ndoxkjua k'oi Florentino, lib. XII, caps. XXIX-XLI (versión de Ángel Ma. Garibay K.).
despwés ya desde k'a ra momento ya k'a ya jíngi bénya'wi já té bimáju̱ k'a ra charroya'wi	Despwés ya desde k'ara momento ya k'ara ya hingi béñawi ja te bimáju̱ k'ara charroya'wi.
despwés ya xo bimu̱fí pe xo diario diario bu̱ nchúi mitsu̱ k'a ra charro mi'óbí k'a ra mikwála	Despwés ya xo bimu̱fi pe xo diario diario bu̱ nchúi mitsu̱ k'a ra charro mi'obi k'a ra mikwála.
goparejájé primero 'á k'a ra parte ánk'ú dínant'í	Gopadejäje primero 'ä k'a ra parte änk'u dinandi.
i asta fecha pues ignoro mucho pero másk'ŭ mäkjámá más ndímáignorajéwi	I hñä jä'i, pues, xki hño, pe̲ ero ma 'batho, ma 'na hño, ma 'na hño, ma 'na hño.
indu̱odiagí bastante	Indu̱diagi b'astante.
inga se̱je̱ ra nntjandi ra manjyati ne ra portuguesa neje ra francesa, inglesa, alemana e italiana,	inga se̱je̱ ra nthe̱thi ra ma̱njäti ne ra portuguesa neje ra francesa, inglesa, alemana e italiana,
k'a mädämé para ke mantenigíjé dígotjó mäbäjtsí pues ni modo dísufréjé	K'a mädämä para ke mantenigíjä dígotho mä bätsi, pues ni modo dí sufrejä.
kómá'u̱té ya fuente níjí	Kómá'ute ya fuente ñäjï.
ne bi unbabi nduntji ya baba, bi enbabi ge mi ne da ñäui ra ndä (emperador) mi b'u̱i nuni manjyati, ne da jäni ra dänga ts'ofo ra evangelio,	ne bi unbabi ndunt'i ya bäbä, bi enbabi ge mi ne da ñäwi ra ndä (emperador) mi b'ui nuni manthiati, ne da jäni ra dänga ts'ofo ra evangelio,
normalmente gójo	Normalme̱nte go̱tho
panteón ga dó	pantheon ga do
pero de sesenta pantsítjá pa gotjók'ŭ kompletamente xatjó ndímáfădijé	Pero de sesenta pants'it'ja pa gojto k'ompletamente xatjo ndimafadhihe.
pero eso sí binújgí mängŭjé kada ná	Pero eso sí binogi mängüxe kada na.
"po nuya kja'i to'o mi pede ge fädi ko ra tjuju ya ""cronistas de las indias”"	"Po nuya kja'i to'o mi pe̱the ge fädi ko ra tjuju ya ""cronistas de las indias""."
pues este kábádá balewa este mínimo siento sinkwenta	Pues este kábatha mbatewa este mínimo siento sinkuenta.
pues nimodo bisufré k'a más ante mäabwelitajé komo mbu̱i enkajoso ra ntsoya	Pues ni modo bi sufri k'a más ante ma mbwelitajë komo mbui enka joso ra ntsoya.
ra nku̱t'i ra juajni ne ya ñ'udi ntjutsi ra agustin yáñez 2da. edición. biblioteca del estudiante universitario, unam, 1950.	Ra nku̱t'i ra juäni ne ya ñ'udi nt'utsi ra Agustin Yáñez 2da. edición. Biblioteca del Estudiante Universitario, UNAM, 1950.
solamente ya riko alkansabi	Solamente ya riko alkansabi.
xi ra tí na ta komedór 'á itsí na ta alimento k'a ra ndăni	Xi ra ti na tha komedór 'a itsi na tha alimento k'a ra ndäni.
xo mitajá ra ntsoya mitá sínko pesos ra béjña dos sinkwenta	xu̱ mitha̱jä ra nts'o̱ya mitha̱ hño̱tho̱ ra bätsi dos sinku̱enta
xo takja mä sesenta wik'a takja mä sesenta bitajkíjéya'wik'a	xo̱ takya ma̱ sesenta wika̱ takya ma̱ sesenta bitajkíjéya'wika̱
á panteón ga dó níjí	A̱ panteón ga do̱ nthe̱he̱.
ñúdigejña dabadijíya' razo''ya' mientra más dandu̱jté	ñudi gejña dabadijíya' razo'ya' mientra más dandu̱jté
-nu'u̱ dige'u̱ b'u̱i nuni maxey (tolimán ne amealco), dige'u̱ temoaya nuni ra ra jyodi estado de méxico ne mar'a ya jyodi nuni puebla ne veracruz	Nu'u̱ dige̱'u̱ b'u̱i nuni maxei (Tolimán ne Amealco), dige̱'u̱ Temoaya nuni ra ra yodi Estado de México ne mar'a ya yodi nuni Puebla ne Veracruz.
ne mätajekitjo di kja getbu̱, ra jñäpi ra joel martinez hernández ne ra jotjo tjuajmä ra natalio hernández xocoyotzin, nuya yojo ya xajnate ri ñ'eje ya y'u̱ dige'u̱ ya ndeznä.	Ne mät'äjeki tho di kja getbu̱, ra jñäpi ra Joel Martínez Hernández ne ra jotho tjuajmä ra Natalio Hernández Xocoyotzin, nuya yojo ya xajnate ri ñ'äjä ya y'u̱ dige'u̱ ya ndeznä.
"-n'ate pa n'a ra zänä de ra r'e̱t'a ma jñäto ""zänä"" mi zo̱ta ya munts'i ya n'ate ya pa ge mi joki ra xihuitl o ""ra m'ede ra kje̱ya"""	"Nate pa na ra zänä de ra r'et'a ma jñäto ""zänä"" mi zota ya munts'i ya nate ya pa ge mi joki ra xihuitl o ""ra m'ede ra kje̱ya"""
bi ma di gepu̱ jam''u̱ ra ngo pa da ts'itje ya it'adeje (Tlahuano) ba po̱ni nubu̱ tlapechhuan. mra ngo ra izcalli.	Bi ma di gepu̱ jam'u̱ ra ngo pa da ts'itje ya it'adeje (Tlahuano) ba po̱ni nubu̱ tlapechhuan. Mra ngo ra izcalli.
bi mu̱di da jyoka ya t'u̱kats'u̱fabo̱kja. ge'a ra ntujni bi nkja nuni Coyohuehuetzin ne ma gojo ba nkja.	Bi mu̱di da yoka ya t'u̱kats'u̱fabo̱kja. Ge'a ra ntujni bi nkja nuni Coyohuehuetzin ne ma goyo ba nkja.
bri tjo ra cuauhnochtli, ra gabida tlacatecco, ra cuapan, ra gabida huitznáhuac, ra makja Amantlan, ne ra makja tlacopan.	B'ri t'yo ra kuawnoxt'i, ra gabida t'lakateko, ra kuapan, ra gabida witn'ahwak, ra makxa Amantlan, ne ra makxa t'lakopan.
bri ts'u̱tuabi ja ra y'u̱ga n'a ra nto̱de dega t'u̱ka joga do dega chalchihuite: made mi juts'i n'a ra tsant'i dega k'astabokja.	Bri ts'u̱tuabi ja ra y'u̱ga n'a ra nto̱de dega t'u̱ka joga do dega chalchihuite: made mi juts'i n'a ra tsant'i dega k'astabokja.
Castañeda, ra t'u ra Aquiyahualcatecuhtli, m ra ndä nuni tlaxcala.	Castañeda, ra t’ú ra Aküyahualkatekuhtli, m ra ndä nuni Tlaxkala.
Coaíhuitl mra gabida ndeznä nuya mapa digeá ra t'o̱t'ats' okamfeni.	Kuaíhuitl mra ngabi nda̱zänä nuya mapa dige ra t'ot'ats' okamfeni.
di gepu̱ ba koi pa nuni ra Xochimilco. nubu̱ ba tu ya kjä'i ya metlatelolco	Di gephu̱ bä k'oi pa nuni ra Xochimilco. Nu̱bu̱ bä tu̱ ya kjä'i ya Metlatelolco.
ebu̱ ba eje man'aki ba te̱nga ra t'o̱jo̱ ra tjuju ra Citlaltépec. Tlacopan, nubia ba o̱t'ra b'u̱i ja ra ndo̱m'ijmu.	Ebo̱ ga eje man'aki ga te̱nga ra t'o̱ho̱ ra tjuju ra Citlaltépec. Tlacopan, nuvia ga o̱t'ra b'u̱i ha ra ndo̱m'ijmu.
ebu̱ bi dädi ra Cihuacóatl:	'bu̱ bi dädi ra Cihuacóatl.
ebu̱ bi ñä ra Cuauhtémoc bi xipabi ra Cihuacóatl:	Ebo̱ bi ñä ra Cuauhtémoc bi xipabi ra Cihuacóatl:
gojo n'ate ya pa ne ebu̱ bi yopa bo̱ni pa di mani ra Huaxtepec, ra Cuauhnahuac (Cuernavaca).	Go̱tho nthe ya pa ne ebu̱ bi yopa bo̱ni pa di mani ra Huaxtepec, ra Cuauhnahuac (Cuernavaca).
gue dá nhuat'i mbo kja ra ximjai,	Güi dá ñu'äti mbo kja ra ximhai.
i nte ra nge'a, ya jmä juts'i ja ra ndäxkjua k'oi ra códice ra ramírez uni nuna b'e̱de mä makjuäni ngu mä ra ntje̱ka b'ede ne ra ndädi nu'a ra nänä mra tjuju ra yacotzin, ra nänä ra ixtlilxóchitl,	I nte ra nge'a, ya jmä juts'i ja ra ndäxkjua k'oi ra códice ra Ramírez uni nuna b'e̱de mä makjuäni ngu mä ra ntje̱ka b'ede ne ra ndädi nu'a ra nänä mra tjuju ra Yacotzin, ra nänä ra Ixtlilxóchitl.
inda jyo ko ra ndäxjua ixtlilxóchtil, ra dada ra Nezahualcóyotl ni ko ra fernando de alva ixtlilxóchitl.	Inda jyo ko ra ndäxjuä Ixtlilxóchitl, ra dada ra Nezahualcóyotl ni ko ra Fernando de Alva Ixtlilxóchitl.
k o ya bu̱' bai, ko ya makahuai,	Go ya bu̱' bä, go ya makahuä.
mi fudi da t'axka ra xudi ba ts'i, bri tját'a ja n'a ra za mi b'ai ja ra ngu ra Ahuizotzin nuni ra Acatliyacapan.	Mi fudi da t'axka ra xudi ba ts'i, bri tját'a ja n'a ra za mi b'ai ja ra ngu ra Ahuizotzin nuni ra Acatliyacapan.
mi gu̱t'a ra ñ'u̱ n'a ra makja ge'a mra b'e̱fi mi zu nu'a ra mäka jai mra tjuju ra Yohualichan.	mi gúthä ra ñ'ú nthä ra makjä geä mra b'ëfi mi zu nu'ä ra mäka häi mra tjuju ra Yohualichan.
mi y'o y'oua, mi tuts'i ya bu̱'bai dega za, ne r'a mi jä dega bo̱ja ne ya mahuai.	Mi y'o y'owa, mi tuts'i ya bu̱'bai dega za, ne r'a mi jä dega bo̱ja ne ya mahuai.
mra ngu ra Aztautzin ge'a mi kja getbu̱ nuni ra Amáxac.	Mra ngu ra Aztautzin ge'a mi kja getbu̱ nuni ra Amáxac.
n'a ra jyo ne man'a bi xokuabi ra debi. ra Cuauhtemoctzin bri xokuabi ra debi ge'a se̱je̱.	Nda̱ ra y'o̱hni man'a bi xoki hñäki ra de̱bi. Ra Cuauhtemoctzin hñäki xoki ra de̱bi ge̱nse̱.
ne m'e̱fa bi ma xki jäki ya je dega magabi, ñätsi bi ntsaya ra mahuai ne ra bu̱'bai, bri nkjonda ya bo̱najmu nuni Acachinanco.	Ne m’ëfa bi ma xki jä’i ya hëdega magabi, ñätsi bi nts’aya ra mahuai ne ra bu’bai, bri nk’onda ya bo’najmu nuni Acachinanco.
ne nkjabu̱ bri t'ot'e neje ko mar'a ya bo̱najmu mi pe̱tsi ra t'u̱ka tsu̱tui ja ya t'u̱ka jnini, nuyu̱ to'o mi b'e̱pi da t'o̱t'e ngu nuni Xalapan, Tlaxcalan, Tehuantepec, Oaxaca neje mar'a ya bo̱najmu mar'a ya t'u̱ka jnini jabu̱ bi guat'i ya nduste, ya dumantjuju dega k'astaboja, ge ya tjuju ya kristiano [...]	Ne nxjabu̱ bri t'ot'e neje ko mar'a ya bo̱najmu mi pe̱tsi ra t'u̱ka tsu̱tui ja ya t'u̱ka jnini, nuyu̱ to'o mi b'e̱pi da t'o̱t'e ngu nuni Xalapan, Tlaxcalan, Tehuantepec, Oaxaca neje mar'a ya bo̱najmu mar'a ya t'u̱ka jnini jabu̱ bi guat'i ya nduste, ya dumantjuju dega k'astaboja, ge ya tjuju ya kristiano.
ne nu'a ri däme, pu̱ ñ'a'i, nugi ga ma ga tsogi'i nuni Cuetlachcoapan [n'a ra jnini nuni puebla],	Ne nu'a ri däme, hñu ñä'i, nugi ga ma ga tsogi'i nuni Cuetlachcoapan, ñä ra jnini nuni Puebla.
ne nu'u̱ bi mani dra ts'okat'o̱t'amfeni nuni Michoacán, Xalisco, Culhuacan ne nuni neje Pánuco, ne nuni Oaxaca, Tehuantepec ne Guatemala, ne nuua ra r'ayo majyati, nub'u̱ bri t'o̱t'a ra mabagi pa dra uadi dra t'o̱t'a nu'a ra ts'okat'o̱t'amfeni inda tsogije se̱je̱.	Nde nu'u̱ bi mani ra ts'okat'o̱t'amfeni nuni Michoacán, Xalisco, Culhuacan ne nuni neje Pánuco, ne nuni Oaxaca, Tehuantepec ne Guatemala, ne nu'u̱ ra r'ayo majyati, nu'b'u̱ bri t'o̱t'a ra mabagi pa ra uadi ra t'o̱t'a nu'a ra ts'okat'o̱t'amfeni nda tsogije se̱je̱.
nejege'a ra ngätsi. mi jä ya mpe̱fi dega mabagi,ya nkjom'a te ne ya fu̱nbo̱kja, inte ma mahuai mi jä ni ge'a ya bu'bai.	Nejege'a ra ngätsi. Mi jä ya mpe̱fi dega mabagi, ya nkjom'a te ne ya fu̱nbo̱kja, inte ma mahuai mi jä ni ge'a ya bu'bai.
njabu̱ bi bo̱nga dega xui. mra ngo nub'u̱ ra Tecuílhuitl bi bo̱nga: nub'u̱ bi kja ya du ja ra r'ani ra deje ya u̱erna.	Ñjabu̱ bi bo̱nga dega xui. Mra ngo nub'u̱ ra Tecuílhuitl bi bo̱nga: nub'u̱ bi kja ya du ja ra r'ani ra deje ya u̱erna.
nub'u̱ bi tjandi ra Tzihuacpopoca, bi t'ena:	Ñub'ú bí thandi ra Tzihuacpopoca, bí t'ena:
nub'u̱ ya ñämfo̱ bi handi ge xa ñ'ehe nubu̱ da tsu̱di, ge mi tekuabi ra nest'ihi, m'estho bi munts'i bi mihi ya mahuai.	Nub'uxu̱ ya ñämfo̱ bi handi ge xa ñ'ehe nubu̱ da tsu̱di, ge mi tekuabi ra nest'ihi, m'estho bi munts'i bi mihi ya mahuai.
nuna jä'i inbi tsa bi thädi majuäni nu'a ra nt'ani. ingra nge'a nuya pa bi hneki n'a ra hyoya jä'i ra macehual (hombre de pueblo),	Nuna jä’i inbi tsa bi thädi majuäni nu’a ra nt’ani. Ingra nge’a nuya pa bi hneki n’a ra hyoya jä’i ra ma’ehual.
nuna nte̱nga b'ede ha bri hat'i ra Tzihuacpopocatzin, bi o̱t'e da thogi ge'a ra ts'e̱y'e̱hmu. inbi bo̱nga nuna nt'o̱t'e bi tsu̱dihu̱ ko ma r'a ya b'e̱hni. ma ra ya ñ'ete inbi hopi da ju̱ man'aki ra ñ'u nuya ts'okate. pe nuya inbi hoki ra b'ai.	Nuna nte̱nga b'ede ha bri hat'i ra Tzihuacpopocatzin, bi o̱t'e da thogi ge'a ra ts'e̱y'e̱hmu. Inbi bo̱nga nuna nt'o̱t'e bi tsu̱dihu̱ ko ma r'a ya b'e̱hni. Ma ra ya ñ'ete inbi hopi da ju̱ man'aki ra ñ'u nuya ts'okate. Pe nuya inbi hoki ra b'ai.
nuua di udihe ra hñäpi bi nto̱t'e bi nja ra agosto ra je̱ya 1595, n'a ra jä'i mra thuhu ra miguel hernández, ra me Chiyauhtzinco,	Nu'u̱ di udihe ra hñäpi bi nt'ot'e bi nja ra agosto ra jä'i 1595, n'a ra jä'i mra thuhu ra Miguel Hernández, ra me Chiyauhtzinco.
nuya bo̱nahmu ya mem'onda ñätsi bi ñäui ra Cihuacóatl Tlacotzin m'estho bi thädi:	Nuya bo̱nahmu ya mem'onda ñätsi bi ñäui ra Cihuacóatl Tlacotzin m'estho bi thädi:
ra Tlacatécatl mra me Cuauhtitlan ne ra bktri ra mbot'a ngu bri japi ya tsat'yo bi zi.	Ra tlakatékatl mra me Kuauhtitlan ne ra bktri ra mbot'a ngu bri japi ya tsat'yo bi zi.
ra doy'e̱ pahni xki njom'i ko ya chalchihuite.	Ra do̱y’e̱ pa̱hni xki njom’i ko ya ch’a̱lchihuite.
ra mu̱di ra Cuauhtémoc, ra hmu ra bondo, ra nyoho ra Tlacotzin, ra Cihuacóatl ra nhñu ra oquiztzin, ra bo̱nahmu ha ra nini ra Azcapotzalco Mexicapan, ra ngoho ra panitzin, ra bo̱nahmu nuni ra Ecatepec,	ra mudi ra Cuauhtémoc, ra hmu ra bondo, ra ñoho ra Tlacotzin, ra Cihuacóatl ra ñuhu ra oquiztzin, ra bonahmu ha ra nini ra Azcapotzalco Mexicapan, ra ngoho ra panitzin, ra bonahmu nuni ra Ecatepec,
ra mu̱di ra pa mi o̱t'e ra ngo ra mäkime ra u, ra thuhu ra Huixtocihuatl	Rä mu̱di rä pa mi o̱t'e rä ngo rä mäkime rä u, rä thuhu rä Huixtocihuatl.
ra nge'a bi mu̱ni ko ra mahuai ha ra xu̱tha nu'a to'o bi umbabi ra ji.	Ra nge'a bi mu̱ni ko ra mahuä ha ra xütha nu'a to'o bi umbäbi ra hi.
ra nyoho, bi tho ra ndä ra Nauhtla, mra thuhu ra Cohualpopocatzin.	Ra ñuhu, bi tho ra nda ra Nauhtla, mra tuhu ra Kogualpopokatzin.
unga ya ngue̱nda te ra ts'omu̱i mi bu̱'i ne mi japi da ntso̱m'i nuya macehualtin, njabu̱ mi thutuabi ya jä'i mi b'u̱i te ma za	Unga ya ngüenda te ra ts'omu̱i mi b'ui ne mi japi da nts'omi nuya macehualtin, njabu̱ mi thutuabi ya jä'i mi b'ui te ma za.
xib'u̱ bri fádi ge nuya he mi ja nuni ra cuauhchichilco, ha Xaltocan; ge mi pttsi ya ndá.	Xib’bö bri fádi ge nuya hëmi ja nuni ra Cuauhchichilco, ha Xaltocan; ge mi pöntsi ya ndá.
xki mbo̱ni nubu̱ ra hyodi ra Cuehuecatitlan,	xki mbo̱ni nubu̱ ra hñodi ra Cuehuecatitlan,
xki thete ra Ixtlilxóchitl ne ra ku ra Cohuanacotzin ko ya he dega dänga ndä bi mu̱di da häni ra hoga ts'ofo ya evangelio,	Xki thete ra Ixtlilxóchitl ne ra ku ra Cohuanacotzin ko ya hëdega dänga ndä bi mudi da häni ra hoga ts'ofo ya evangelio.
ya dänga ñu̱ni nsafi, ya nsafi, ya mahuai, hangu nu'u̱ gatho xki tagi mbo ha ra hñe.	Ya dänga ñu̱ni nsafi, ya nsafi, ya mahoi, hangu nu'u̱ gatho xki tagi mbo ha ra hñe.
bi o̱tuabi nu'a ra makja xki nk'ohni mra thuhu ra alonso ruiz, ge mi y'o nuni huamuxtitan (Huamuxtitlan) nuni ra hyodi guerrero.	bi o̱tuabi nu'a ra makjä xki nk'ohni mra thuhu ra alonso ruiz, ge mi y'o nuni huamuxtitlan (Huamuxtitlan) nuni ra hyodi guerrero.
di pädi xahño nuna b'e̱fi nehe yoho to'o di pädi da mpe̱fi da y'este nuya hoga do mahye̱gi ya xito, mra thuhu ra ambetz'ihuay.	Di pädi xañu nuna b'efi nehe yoho to'o di pädi da mpefi da y'este nuya hoga do mahyegi ya xito, mra thuhu ra ambetz'i huäy.
dra thoki ra nto̱de, ra ketzal dra b'e̱ nuni Coyohuacan.	Ra thoki ra nt’ot’e, ra k’ets’i ra bä nuni K’oyowaka.
e mi r'ani dega xui ra Cihuacóatl g'ea mi zoni ne mı mafi.	E mï r'ani dega xui ra Cihuacóatl g'ëä mï zoni ne mï mafi.
ebu̱ bi gäi habu̱ mi to̱ge ebu̱ bi yopa ma ha ra hnini ra Cuetaxtlan,	Ebo̱ bi gä'i habu̱ mi to̱ge ebo̱ bi yopa ma ha ra hnini ra Kuetaxtlan.
ge'a ra mu̱di ra thuhu ra Hernando, ra nge'a njabu̱ mra thuhu ra takjä ra Cortés nehe njabu̱ mra thuhu ra ndä católico ne ra ku ra Cohuanacotzin bi thutuabi ra Pedro po ra Pedro Alvarado ra nge'a ra takjä,	Geʔa ra mudi ra thuhu ra Hernando, ra ngeʔa njabu mra thuhu ra takjä ra Cortés nehe njabu mra thuhu ra ndä católico ne ra ku ra Cohuanacotzin bi thutuabi ra Pedro po ra Pedro Alvarado ra ngeʔa ra takjä.
ma n'a mi b'ai nuni teotletso, habu̱ ra ñ'u̱ pa manjuäntho pa da zo̱ni nuni ra peñón (Tepetzinco).	Ma n'a mi b'ai nuni teotletso, habu̱ ra ñ'u̱ pa manjuäntho pa da zo̱ni nuni ra peñón (Tepetzinco).
"mi tso̱ho̱ getbu̱ ra fu̱nga t'o̱ho̱, habu̱ mi thutuabi ""tajón ra nxu̱ni, njabu̱ bi hutuabi ya ndeznä ya b'e̱hnanoya bi pe̱hni ra ts'e̱y'e̱hmu, mi gu̱t'a ra ñ'u ra Tzihuacpopocatzin, bi bo̱nga ha ra ñ'u."	"Mi tso̱ho̱ getbu̱ ra fu̱nga t'o̱ho̱, habu̱ mi thutuabi ""tajon ra nxu̱ni, njabu̱ bi hutuabi ya ndeznä ya b'e̱hnanoya bi pe̱hni ra ts'e̱y'e̱hmu, mi gu̱t'a ra ñ'u ra Tzihuacpopocatzin, bi bo̱nga ha ra ñ'u."
mra ku ra Cacamatzin mra bo̱nahmu nuni Tetzcoco mri ñ'oui va jä'i mi y'o mpaha.	Mra ku ra Kakamatzin mra bo̱nahmu nuni Tetzcoco mri ñ'oui va jä'i mi y'o mpaha.
n'a ra nto̱de dega chalchihuite, xi m'et'e dega ze̱ka do, nehe mi pe̱tsi n'a ra tsant'i de ga k'astaboja.	N'a ra nt'ot'e dega chalchihuite, xi m'et'e dega zeka do, nehe mi pe̱tsi n'a ra tsant'i dega k'astaboja.
ne ndunthi ya ambetz'ihuay ne mar'a hoga do mi pe̱tsi ra mu'ui:	Ne ndunthi ya ambetz'i huäi ne marä hoga do mi pëtsi ra mu'ui.
nehe n'a ya the̱sthi dega mboťahuaido.	Nehe n’a ya the̱sthi dega mbo̱thuaido.
nuna bi o̱t'a ra ntso̱m'i ra nge'a nehe nuya ya b'e̱datsi bi tsini ko ra Cortés ne ra Cohuanacotzin ne ra ixtlilxóchitl xki nsofo pa ra ixtlilxóchitl da gu̱ka ya jä'i ge mi zu ya hyodi, njabu̱ mi pe̱hna ajuä da t'o̱t'e.	Nuna bi o̱t'a ra nts'o̱m'i ra nge'a nehe nuya ya b'e̱datsi bi ts'ini ko ra Cortés ne ra Cohuanacotzin ne ra Ixtlilxóchitl xki nsofo pa ra Ixtlilxóchitl da gu̱ka ya jä'i ge mi zu ya hyodi, njabu̱ mi pe̱hna ajuä da t'o̱t'e.
nuna nt'o̱t'e bi nthandi xa nts'ogi njabu̱ bri thutuabi, bi ena ge mra nzu̱te ko ma m'u̱hai ra nzu̱te ne mi thutsuabi ko ya mpe̱bi dega mabagì, habu̱ hmä ge n'a di ge'u̱ bi y'e̱nga n'a ra do, ko nge'a bi hyo, nu'u̱ mar'a ya b'e̱go ge mä ge nu'u̱ se̱he̱ ya ñämfo̱ bi hyo bi mu̱tu'a n'a ra mahuai ha ri ngati bi mu̱tuabi n'a ra nzu̱ni.	Nuna nt’ot’e bi nthandi xa nts’ogi njabu̱ bri thutuabi, bi ena ge mra nzute ko ma m’uhai ra nzute ne mi thutsuabi ko ya mpe̱bi dega mabagì, habu̱ hmä ge n’a di ge’u̱ bi y’e̱nga n’a ra do, ko nge’a bi hyo, nu’u̱ mar’a ya b’e̱go ge mä ge nu’u̱ se̱he̱ ya ñämfo̱ bi hyo bi mu̱tu’a n’a ra mahuai ha ri ngati bi mu̱tuabi n’a ra nzuni.
ra Cuauhtémoc, Tlacotzin, ra Cihuacóatl, Oquiztzin, Panitzin, Motelhuihtzin; nuna bi sofo ra Cortés nuni Coyoacan, nu'u̱ to'o mi pädi yoho ya hñäki ngu'a ra jerónimo aguilar ra malintzin.	Ra Cuauhtémoc, Tlacotzin, ra Cihuacóatl, Oquiztzin, Panitzin, Motelhuihtzin; nuna bi sofo ra Cortés nuni Coyoacan, nu'u̱ to'o mi pädi yoho ya hñäki ngu'a ra Jerónimo Aguilar ra Malintzin.
t'ena ge ya macehual [ya jä'i b'u̱i ha ra hyoya]	T’ëna ge ya ma’ëhual [ya jä’i b’ui ha ra hyoya]
"xki thokuabi nuya hotho ts'ints'u̱ mra thuhu ra ""tlauhquecho"" ne “tzinitzcan zacuan"","	"xki thokua̱bi nuya hoto ts'ints'u̱ mra thuhu ra ""tlauhquecho"" ne “tzinitzcan zacuan”,"
-¿te be'a gi mä nu'i Cihuacóatl?	-¿Te bädi gi mä nuthi Cihuacóatl?
bi k'ahni ko ya dänga ñuni nzafi ne bi thetse ko ya makahuai nuya otomi geb'u̱ bi japi bi b'e̱di, bi mä nuyu̱:	Bi k'ahni ko ya dänga ñuni nzäfi ne bi thetse ko ya makahuai nuya hñätho ge'bü bi japi bi b'edi, bi mä ñuyu:
da thuts'i ya njot'ihñä ( )	Da thuts’i ya ñ’ot’ihñä.
da umbabihe te da zi, da japabihe ndunthi ma zu.	Ra umbabihe te ra zi, ra hapabihe ndunthi ma hñu.
ebu̱ bi mä nuna b'e̱fi xa thoki xahño bi johya ra ts'e̱y'e̱hmu.	Ebo̱ bi ma nuna b'e̱fi xa thoki xañu bi johya ra ts'e̱y'e̱hmu.
"fernando alva ixtlilxóchitl, xiii njändahmä ""ra ñ'ehe ya ñämfo̱ ne ra mu̱di ra hoga ts'ofo ra evangelio."""	"Fernando Alva Ixtlilxóchitl, XIII ñändähmä ""ra ñähe ya ñä'äfo̱ ne ra mudi ra hoga ts'ofo ra evangelio."""
ga juatihu̱ nu'a huts'i njani, ya ts'ojä'i, ra carranza, ge xa o̱t'a ya ts'okuate pa gekagihu̱; ga o̱t'e da nja ra ts'e̱di ma munts' ne njabu̱ ga tsu̱dihu̱ da nja nu'a ra hoga tsu̱tui, da nja ra hai, ra hñegi ne ra hoga ts'u̱tui;	Ga juatihu̱ nu'a huts'i njani, ya ts'ojä'i, ra Carranza, ge xa o̱t'a ya ts'okuate pa gekagihu̱; ga o̱t'e da nja ra ts'e̱di ma munts'i ne njabu̱ ga tsu̱dihu̱ da nja nu'a ra hoga tsu̱tui, da nja ra hai, ra hñegi ne ra hoga ts'u̱tui.
gatho ya hyoyajä'i mi b'u̱i ha ra hnini bi handi.	Gatho ya hyoya jä'i mi b'ui ha ra hnini bi handi.
ha bi häni ra ñ'udi, ma jä'ihu̱ bi ent'i gatho mahye̱gi nuya nzu̱te	Ha bi häni ra ñ'udi, ma jä'i hñu̱bi ent'i gatho mahye̱gi nuya nzute.
ha n'aa nza̱tho xudi ra pale berto, bi bo̱ni nda hyonga te nda nzimxidi ngetho nda zi ya hme hyaxtho mi u̱xa ya u, ua ngu mi nzäi mi nkahui yá hme nuya txuju̱ xa hogi ha nuya 'bomuha̱i nts'ät'i, nt'o̱kuä;	Ja nää nzatho xudi ra pale Berto, bi boni nda hyonga te nda nzimxidi ngetho nda zi ya hme hyaxtho mi uxa ya u, ua ngu mi nzäi mi nkahui ya hme nuya txuju xa hogi ja nuya bomuhai nts'ät'i, nt'okuä.
ha nubia di ndäki, di ndändiñähmu, di ma ga ts'u̱tsa'i ri y'e, ga ndäne'i ra nge'a nu'a'i ma makjahe, ra bartolomé lópez, nub'u̱ mi njuäni ma b'e̱hña inbi njuäni ha nubu̱ mi xaxi pa da o̱t'a ya tso̱mfen	Ha nubya di ndäki, di ndändiñähmu, di ma ga ts'u̱tsa'i ri y'e, ga ndäne'i ra nge'a nu'a'i ma makjahe, ra Bartolomé López, nu'b'u̱ mi njuäni ma b'e̱hña inbi njuäni ha nubu̱ mi xaxi pa da o̱t'a ya tso̱mfen.
ha ya t'u̱ka ze̱ki thuts'i n'a tu̱kitho nuna thogi ge bi huxa ra fernando alva ixtlilxóchitl, nu'a b'e̱tsi ra xiiii njondahmä.	Ha ya t'uka zeki thuts'i n'a tukitho nuna thogi ge bi huxa ra Fernando Alva Ixtlilxóchitl, nu'a b'etsi ra xiiii njondahmä.
habu̱ ga ju̱he nuyu̱ (ya tenochcas) te gi honihu̱?	Häbu̱ ga juhä nuyu̱ (ya tenochcas) te gi honihu̱?
ham'u̱ gatho ya juän'ahmä ge nuua xa ze̱ti ri ñ'ehe dige'a ya noya ya mu̱dimehai ha ra hñä ya ndeznä, nuna thuhu ri uni inga se̱he̱ ra n'atsanoya pa da fädi ra hñämfo̱, ingi ri me̱udi dige'a ra hmä fu̱oti dige'a nuna ra hñäki ra netzahualcoyotl. ne ra cuauhtémoc.	ham'u̱ gatho ya juän'ahmä ge nu'u̱a xa ze̱ti ri ñ'ehe dige'a ya noya ya mu̱dimehai ha ra hñä ya ndeznä, nuna thuhu ri uni inga se̱he̱ ra n'atsanoya pa da fädi ra hñämfo̱, ingi ri me̱udi dige'a ra hmä fu̱oti dige'a nuna ra hñäki ra netzahualcoyotl. ne ra cuauhtémoc.
mi hneki ngu ma jä'ihu̱ ngabu̱ mri hneki.	Mi hneki ngu ma jä'i̱hu̱ ngabu̱ mri hneki.
ndunthi bri johya, bri thuxpabi gatho nu'a mi o̱t'abi ra b'edi, ko nge'u̱ bi m'u̱i ne mi t'umbabi ya t'ixu:	Ndunthi hñä johya, hñä thuxpabi gatho nu'a mi o̱t'abi ra b'edi, ko nge'u̱ bi m'u̱i ne mi t'umbabi ya t'ixu.
ngu mra me̱ti, nu'a r'a hyodi, habu mi y'o, n'a ngu n'a mi johya mi mfe̱m'a xinxi xi mi johya ya ndäte, mi thede n'a ngu n'a mi hñu̱fi ne mi fe̱m'a ya xinxi: xi mi b'u̱i mpaha.	Ngu mra me̱ti, nu'a r'a hyodi, habu mi y'o, n'a ngu n'a mi johya mi mfe̱m'a xinxi xi mi johya ya ndäte, mi thede n'a ngu n'a mi hñu̱fi ne mi fe̱m'a ya xinxi: xi mi b'u̱i mpaha.
njabu̱ ri ñ'ehe ya je̱ya inda m'e̱di, inda mpumfri, ga nzäi ga pe̱tsi nugagihu̱ ha ma mfenihu̱, ga pe̱tsi nugagihu̱, ra bätsi dige'u̱, ya b'e̱to, ya ntsaniku, ya mbänga b'e̱to ne to'o dra ñ'epu̱, to'o mahye̱gigihu̱, ma jihu̱, ya ku̱hu̱.	ñjabu̱ ri ñ'ehe ya je̱ya nda m'e̱di, nda mpumfri, ga nzäi ga pe̱tsi nugagihu̱ ha ma mfenihu̱, ga pe̱tsi nugagihu̱, ra bätsi dige'u̱, ya b'e̱to, ya ntsaniku, ya mbänga b'e̱to ne to'o dra ñ'epu̱, to'o mahye̱gigihu̱, ma jihu̱, ya ku̱hu̱.
nu xä oth'u̱, ma gä ñ'jähu̱	Nu xä oth'u, ma ga ñ'jahu.
nuga̱ xi di ne'i, hindi pädi hanja...	Nuga̱ xi di ne'i, hñädi pädi hñä...
num'u̱ di johyahu̱, nkuehu̱, nts'o̱mihu̱, tsuhu ne pa da t'o̱xkähu̱ di hohñu̱ nu ya nt'u̱i xi di 'yoohu̱ (¡!). nuya da nt'ot'i ko ra dänt'ot'í	Ñum'ú di johyahú, nkúehú, nts'öhíhú, tsúhú ne pa da t'öhkähu̱ di hohñú nu ya nt'úi xi di 'yoohú (¡!). Nuya da nt'ot'i ko ra dänt'ot'í.
nuna bi johya ha ra mabagi,	Nuna bi yohya ha ra mabagi.
nuya hñu o gohoya pa bi b'u̱i nubu̱ bi xitsuabi ra jäpadehe ndunthi ya jä'i, ngu xa t'ena.	Nuya hñu o gohoya pa bi b’ui nubu bi xitsuabi ra jäpadehe ndunthi ya jä’i, ngu xa t’ena.
nuya tsat'io mi b'et'o, mi gu̱t'a ra ñ'u, mi teni, ya xiñu mi ju̱ts'i pa mañä, xi mi pähä gatho mi handi mi nest'ihi: mi tu̱ta ya jihni	Nuya tsat’iö mi b’ët’o, mi güthä ra ñ’u, mi teni, ya xiñu mi hñuts’i pa mañä, xi mi pähä gatho mi handi mi nest’ihi: mi thüta ya hñähñi.
pe, nu'i ndada nu'i ma t'ek'ei ra makja, nub'u̱ nu'i ingi zugagihe, ¿hanja, nuua, ra hyo di ge'a, ga tsogi nubu̱ [nu'a ma b'e̱hña]?	Pe nu'i ndada nu'i ma t'ek'ei ra makja, nub'u̱ nu'i ingi zugagihe, ¿hanja, nu'a, ra hyo di ge'a, ga tsogi nubu̱ nu'a ma b'e̱hña?
r'a ya jä'i mi b'u̱i ha ra ngumi ja nunu ha ra hnini ri manjuäntho pa da tsoni nubu̱ ra amáxac,	r'a ya jä'i mi b'u̱i ha ra ngumi ja nunu ha ra hnini ri manxuäntho pa da tsoni nubu̱ ra amáxac,
ra nge'a di o̱t'a nuna noya ra ts'u̱tui ne gatho to'o da guat'a ha ma hyohe, nu'u̱ to'o da ne, da me̱tsi n'a ra hoga m'u̱i ne da m'u̱i manjuänthä. ha nubu̱ xa mabu̱ ma noya ge di pe̱tsi ra tsa, dega hoga jä'i ne dega hogat'o̱t'antuhni	Ra nge'a di o̱t'a nuna noya ra ts'u̱tui ne gatho to'o da guat'a ha ma hyohe, nu'u̱ to'o da ne, da me̱tsi n'a ra hoga m'u̱i ne da m'u̱i manjuänthe. Ha nubu̱ xa mabu̱ ma noya ge di pe̱tsi ra tsa, dega hoga jä'i ne dega hogat'o̱t'antuhni.
ra ngehna nuna pa bi ma n'a ra ñ'u manjuäntho.	Ra ngehna nuna pa bi ma n’a ra ñ’u manjuätho.
ra nhñu ne ra ngästsi ra b'ist'ofo di huts'ihu̱ ha nuna ze̱ki b'ist'ofo, ri ñ'ehe ra vii njondahmä ra chimalpain,	Ra ñuhu ne ra ngästsi ra b’ist’ofo di huts’i hũ ha nuna zẽki b’ist’ofo, ri ñ’ehe ra vii njondahmä ra chimalpain.
ra nthädi ra cuitlahuacatzin bi ena ge ina da o̱t'e nuya bi b'e̱pabi ya nso̱ho̱jä'i,	Ra nthädi ra Cuitlahuacatzin bi ena ge ina da o̱t'e nuya bi b'e̱pabi ya nso̱ho̱jä'i.
ra nyoho nu'a mi zu ra tepoztlan; ra nhñu ra me tizatlan, ra njoho mi ñ'ehe nuni huehuetlan ne ra nku̱ta mra dänga mictlan.	Ra ñuhu nu'a mi zu ra Tepoztlán; ra ñuhu ra me Tizatlan, ra ñuhu mi ñ'ehe nuni Huehuetlan ne ra nkuta mra dänga Mictlan.
ri ñ'udi xahño nubia hanja beni ya metlaxcala bi do̱m'i mpaha nuya nso̱ho̱ jä'i.	Ri ñudi xañu nubia hanxa b'eni ya Metlaxkala bi do̱mi mpaha nuya nso̱ho̱ jä'i.
t'ena ge inbi unga mfädi pa gatho ya jä'i mi ñ'oui, ge nuna ndada ra marqués da ñ'ehe dra hmu ha ma haihe, da ja me̱ti nu'a di pe̱tsihe nehe dra jakagihe ga mpe̱fihe ra hai ge bi umbabi o bi hänbabi ya hoga hai ya n'añ'o hnini.	T'ena ge inbi unga mfädi pa gatho ya jä'i mi ñ'oui, ge nuna ndada ra marqués da ñ'ehe dra hmu ha ma haihe, da ja me̱ti nu'a di pe̱tsihe nehe dra jakagihe ga mpe̱fihe ra hai ge bi umbabi o bi hänbabi ya hoga hai ya n'añ'o hnini.
xi mi taxki ra ñ'u, imbi tsa da r'anga n'a, ho̱nse̱he̱ mi taxka n'a ha ra bo̱hai. ya y'ofadi mi ju̱t'atho.	Xi mi taxki ra ñ'ú, imbi tsa da r'anga n'a, hönsähe mi taxka n'a ha ra bohai. Ya y'ofadi mi hüt'atho.
ya dänga mfu̱nga bo̱jä bi ntho, bi kot'i ko ya mahjuai, mi zu̱m'i nehe ko ya t'e̱nga ts'u̱t'abo̱ja.	ya dänga mfu̱ngi bo̱jä bi ntho, bi kot'i ko ya mahjuai, mi zu̱m'i nehe ko ya t'e̱ngi ts'u̱t'abo̱ja.
ya r'atsanoya ra sahagún mi mä hanja mi yopa tsini. ya ndeznä bi nkohi inda ñ'udi. mi hatatho pa bi mu̱di ra ntuhni	Ya r'atsanoya ra Sahagún mi mä hanxa mi yopa ts'eni. Ya ndezna bi nkohi nda ñ'udi. Mi hatatho pa bi mudi ra ntuhni.
ya zi b'e̱hña mi ägi ha ya b'a ne ha ya ngo̱de, nuya ñ'o̱ho̱ mbo ha ya ne, ha ya njom'ahudi.	Ya zi b’ehña mi ägi ha ya b’a ne ha ya ngo̱de, nuya ñ’o̱ho̱ mbo ha ya ne, ha ya njom’ahudi.
bi boxro xi 'be̱ts'ina, bido'u̱ ro 'yu̱ni 'na, xi bi bo̱x ro hjua 'na, bido'u̱ ro ts'ii 'na, xi bo̱xro ts'äre 'na. ge'bu̱ go min pu̱n doja 'na.	Bi boxro xi 'be̱ts'ina, bido'u̱ ro 'yu̱ni 'na, xi bi bo̱x ro hño 'na, bido'u̱ ro ts'ii 'na, xi bo̱xro ts'äre 'na. Ge'bu̱ go mi puntho ja 'na.
bi ma manjuäntho habu̱ mi b'u̱i ra ts'e̱y'e̱hmu bi xipabi;	Bi ma manxuänt’o habu̱ mi b’u̱i ra ts’e̱y’e̱hmu bi xipabi.
bri juahni po nuya dra hmu.	B'ri xjuani po nuya ra hñu.
di to̱m'ihe ra ñ'ethi pa nugagihe, n'a ra pa ngu ma n'a ra pa thogi nekagihe di huadihe ra nge'a indi tse̱tihe nuna b'u̱i t'o̱t'e ko ngekagihe man'año ya ntho, t'e̱nts'igihe thi ma haihe ma me̱tihe, ju̱kagihe ga mpe̱fihe ndunthi, b'e̱kagihe ga jut'ihe xdunthi ya boja, n'a ngu n'a ra pa nuna njut'i di o̱t'ehe man'a te ma thaihe di tuhe.	Di to̱m'ihe ra ñ'ethi pa nugagihe, n'a ra pa ngu ma n'a ra pa thogi ne kagihe di huadihe ra nge'a indi tse̱tihe nuna b'u̱i t'o̱t'e ko nge kagihe man'año ya ntho, t'e̱nts'i gihe thi ma haihe ma me̱tihe, ju̱kagihe ga mpe̱fihe ndunthi, b'e̱kagihe ga jut'ihe xdunthi ya boja, n'a ngu n'a ra pa nuna njut'i di o̱t'ehe man'a te ma thaihe di tuhe.
gatho nuna hai ha nuna r'ayo ximhai njabu̱ bi thutuabi nuya nso̱ho̱jä'i inbi tsa bi thutuabi man'a ra thuhu.	Gatho nuna hai ha nuna r'ayo ximhai njabu̱ bi thutuabi nuya nso̱ho̱jä'i inbi tsa bi thutuabi man'a ra thuhu.
ha mi tso nde, bi mu̱di bi nja n'a ra hneki ngu njagihu̱ dega jä'i, bi t'ot'e ra b'ai ngu dega jä'i,	Ha mi tso nde, bi mu̱di bi nja n'a ra hneki ngu njagihu̱ dega jä'i, bi t'ot'e ra b'ai ngu dega jä'i.
ma bo̱nahmu'ihe: nuna b'e̱fi ga tsokagihe sta juatihe gatho: gi nuti nuua, xa hño bo̱nahmu.	Ma bo̱nahmu'ihe: nuna b'e̱fi ga tsokakihe sta juatihe gatho: gi nut'i nuha, ja hño bo̱nahmu.
mi mä dega ts'e̱dira hñä tso̱pu da ts'o̱ho̱bu nuya nzo̱ho̱jä'i ga handihu̱ te ma ts'e̱di pe̱tsi, ra nge'a ma ajuä ra quetzalcohuatl b'u̱i nuua ko ngekagihu̱,	Mi ma dega ts'edi ra hñä tsopuda ts'ohobu nuya nzohöjä'i ga handi hute ma ts'edi pe̱tsi, ra nge'a ma ajuä ra Quetzalcoatl b'ui nuya ko ngekagihu.
ne ya nt'u̱i, hanja di thuts'i ya nt'ofo, njap'u̱ nehe mä 'ra ya mpeu̱i da fats'i di nt'ot'i ra hñähñu	Ne ya nt’ui, hanja di thuts’i ya nt’ofo, ñäpä nehe mä ra ya mpei da fätsi di nt’ot’i ra hñähñu.
nub'u̱ nu'i ingi japi da bo̱nga nu'a ra makja ha nu'a ra hnini, ¿hanja ra yotui, ga tso̱gi nubu̱ ma b'e̱hña? o̱t'a r'ato ya je̱ya bi mu̱di [ra makja ra bartolomé lópez]	Nub'uu nu'i ingi japi da bo̱nga nu'a ra makxa ha nu'a ra hnini, ¿hanxa ra yotui, ga tso̱gi nubu̱ ma b'e̱hña? O̱t'a r'ato ya je̱ya bi mu̱di [ra makxa ra Bartolomé López].
pa ga b'u̱i mpaha ne ga o̱t'e n'a ra njondahmä gatho nu'a ga handi.	Pa ga b'ui mpaha ne ga o̱t'e n'a ra njondahmä gatho nu'a ga handi.
r'a nuna mi nthandi ngu nu'a ma thänjuahu̱ (ychtlilmatli), xi mra nts'o, mi kuet'e ha ya ngo̱,	r'a nuna mi nthandi ngu nu'a ma thänjuahu̱ (ychtlilmatli), xi mra nts'o, mi kuet'e ha ya ngo̱.
xa zägi mpaha, nub'u̱ xa njabu̱ xa japabi ma zu ne inte xa t'o̱tuabi nub'u̱ inda japi xa po̱ho̱ bi ya kue̱ ra nge'a ya jä'i xi mra no̱t'e ne mra hyotejä'i,	Xa zägi mpaha, nu'bë xa njabu̱ xa xapabi ma zu ne inte xa t'ot'u̱abi nu'bë inda xapi xa po̱ho̱ bi ya kue̱ ra nge'a ya jä'i xi mra no̱t'e ne mra hyotejä'i.
y'o, ri ma ne gi xipabihu̱ ya metlaxcala ge ma r'a ya me̱ti jä'i ne ri ajuähu̱, ge nu'a ga mä ge xa ehe nuua ma haihu̱, ge di umbabihe ma nthädihe.	Ñu̱hmu, ri ma nge gi xipabihua ya metlaxcala ge ma ra ya me̱ti jä'i ne ri ajuähu̱, ge nu'a ga mä ge xa ehe nu'a ma haihu̱, ge di umbabihe ma nthädihe.
¿te da o̱t'e ma jä'ihu̱ sta b'e̱dihu̱?	¿Té da o̱t'e ma jä'ihü̱ sta b'e̱dihü̱?
-da ts'iua:... ri ñ'ehe ge'a ma njueih'u̱. da o̱t'ehe ya ñ'o̱te ko ya he̱m'i, ya ñ'o̱t'ehe ko ya ntuts'i. da o̱ts'e̱ ra b'e̱na noya.	Da ts'iwa:... ri ñähe ge'a ma ñu̱hmu. Da o̱t'ehe ya ñ'o̱te ko ya he̱m'i, ya ñ'o̱t'ehe ko ya nt'uts'i. Da o̱ts'e̱ ra bä̱na noya.
-dom'i ma ajuähu̱ ge inda yu̱t'a ha ma nguhu̱ nuhu̱ to'o e̱nts'i pa thi ne da hokuabi ra honanhyo nub'u̱ sta ne da hyoki ya inda za.	-Dom'i ma ajuähu̱ ge nda yut'a ha ma nguhu̱ nuhu̱ to'o e̱nts'i pa thi ne da hokuabi ra honanhyo nu'b'u̱ sta ne da hyoki ya nda za.
-o̱t'a ra mäte gi o̱dehu̱, ja gi b'ai nuuahu̱. mont'a ya ngo ajuä; ri juat'i ra ngo ga tsunda ma ajuähe.	-’ot’a ra mäte gi othehu, ja gi b’äi nuähu. m’ot’a ya ngo ayu; ri juat’i ra ngo ga ts’ünda ma ayuhe.
-xa hño, di b'u̱ihe njamädihe.	Ja hñö, di b’uihe ñamädihe.
-¿nguande njabu̱ ga mäu gra juähu̱?	-¿Nguande ñäbu̱ ga mäjü gra juähu̱?
-ñ'emabagi, ya gabida, ya jä'ihu̱ gi pädi ra ntuni ra mem'onda ba ehehu̱ ga te̱nihu̱ma nzu̱tehu̱. ko ya mätsa mi te̱he̱, ko ya bu̱'bai ko ngatho ra ts'e̱di mi te̱he̱ ra ñ'u.	Ñ'emabagi, ya gäbida, ya jä'i̱hu̱ gi pädi ra nt'uni ra mem'onda ba ehe̱hu̱ ga te̱nihu̱ma nzutehu̱. Ko ya mätsa mi te̱he̱, ko ya bu̱'bai ko ngatho ra ts'e̱di mi te̱he̱ ra ñ'u.
bi tse̱ti nuna ngot'i ra m'onda, ngu pede ra dänga b'ede, ya k'oi ne ya njändahmä, ngu nu'a ra hmä ra alonso axayaca, goho n'ate ma pa bi nzo̱t'e nuna pa.	Bi tse̱ti nuna ngot'i ra m'onda, ngu pe̱de ra dänga b'ede, ya k'oi ne ya njändahmä, ngu nu'a ra hmä ra Alonso Axayaca, goho n'ate ma pa bi nzot'e nuna pa.
into y'o manjuäntho, into pa ri nektho.	Mbi̱i̱ y'o manxuanto, mbi̱i̱ pa ra ne̱ktho.
nub'u̱ ndi umbabihe ma njut'ihe xki nzäi ndi da'ihe, mi adi n'a tu̱ki nehe nub'u̱ ndi unihe ya k'astaboja mi häni made n'a tu̱ki [...]	Nub'u̱ ndi umbabihe ma njut'ihe xki nzäi ndi da'ihe, mi adi n'a tu̱ki nehe nub'u̱ ndi unihe ya k'astaboja mi häni made n'a tu̱ki [...]
ya miñ'o ko ngehna hmä ri johya,	Ya miñ’o ko ngehna hmä ri johya.
bi tso̱hso̱ ra ngo ma ajuähu̱: nubia da fu̱di da guadi ra r'e̱t'a ra pa.	Bi tso̱hso̱ ra ngo ma ajuähu̱: nubia da fu̱di da guadi ra r'e̱t'a ra pa.
